00C	ANIMAS AIR PARK
00M	THIGPEN FIELD ARPT
00OI	MIAMI VALLEY HOSPITAL HELIPORT
01G	PERRY-WARSAW ARPT
02C	CAPITOL
05C	GRIFFITH-MERRILLVILLE ARPT
06D	ROLLA MUNICIPAL ARPT
06FA	WM P GWINN ARPT
07F	GLADEWATER MUNICIPAL ARPT
07FA	OCEAN REEF CLUB
08C	RIVERVIEW
09J	JEKYLL ISLAND ARPT
09LA	ERA HELICOPTERS FOURCHON HELIBASE
09N	AIRHAVEN
09R	TYLER COUNTY ARPT
0A9	ELIZABETHTON MUNICIPAL ARPT
0B8	ELIZABETH FIELD ARPT
0G6	WILLIAMS COUNTY ARPT
0IL1	LOYOLA U MED CTR HELIPORT
0LA7	EXXON HELIPORT
0M5	HUMPHREYS COUNTY ARPT
0NC4	WAKE MEDICAL CENTER HELIPORT
0PS2	MARIAN HELIPORT
0Q4	SELMA
0S9	JEFFERSON COUNTY INTL
0TX1	PECAN PLANTATION ARPT
0V6	MISSION SIOUX ARPT
12N	AEROFLEX-ANDOVER
12V	ONA AIRPARK ARPT
12Y	LE SUEUR MUNICIPAL
14G	FREMONT AIRPORT
15TE	ARCO HIGH ISLAND HELIPORT
17N	CROSS KEYS ARPT
18GA	SLEEPY HOLLOW ARPT
1AZ0	MOBILE AIRPORT
1B1	COLUMBIA COUNTY ARPT
1B9	MANSFIELD MUNICIPAL
1C5	BOLINGBROOKS CLOW INTL
1C9	FRAZIER LAKE AIRPARK
1F0	ARDMORE DOWNTOWN EXECUTIVE ARPT
1G3	KENT STATE UNIVERSITY
1G4	GRAND CANYON WEST
1H0	CREVE COEUR ARPT
1I5	FREEHOLD ARPT
1I9	DELPHI MUNICIPAL ARPT
1J9	FT WALTON BEACH ARPT
1M9	LAKE BARKLEY STATE PK ARPT
1MO3	LAKE VIKING
1O2	LAMPSON FIELD ARPT
1O6	DUNSMUIR MUNICIPAL-MOTT ARPT
1Q5	GRAVELLY VALLEY
1R8	BAY MINETTE MUNICIPAL
1TE6	MOORE AIRPORT -WILDORADO
1U7	BEAR LAKE COUNTY ARPT
1V0	NAVAJO LAKE ARPT
20E	MARICOPA MEDICAL CENTER HELIPORT
20N	KINGSTON-ULSTER ARPT
23S	SEELEY LAKE
24LA	ERA HELICOPTERS CAMERON BASE HELIPORT
24VA	CHERRYSTONE ARPT
26A	ASHLAND/LINEVILLE
26N	OCEAN CITY MUNICIPAL -NJ
28J	PALATKA MUNICIPAL ARPT - LT KAY LARKIN FLD
28NJ	STEEL PIER TAJ MAHAL HELIPORT
2A0	MARK ANTON AIRPORT
2A5	CAUSEY ARPT
2B7	PITTSFIELD MUNICIPAL -ME
2G1	CONCORD AIRPARK
2G2	JEFFERSON COUNTY ARPT
2I0	MADISONVILLE MUNICIPAL
2LA0	CENTRAL INDUSTRIES
2LS0	AIR LOGISTICS GALLIANO HELIPORT
2MO1	BIRD FIELD AIRPORT
2N8	MARLBORO ARPT -CLOSED
2O1	GANSNER FIELD
2R2	HENDRICKS COUNTY-GORDON GRAHAM FIELD
2R4	PETER PRINCE FIELD ARPT
2R9	KARNES COUNTY ARPT
2S1	VASHON MUNICIPAL ARPT
2W2	CLEARVIEW AIRPARK
2W6	ST. MARYS COUNTY REGIONAL
2WA1	DIAMOND POINT AIRSTRIP
32S	STEVENSVILLE
33N	DELAWARE AIRPARK
33R	GROVETON-TRINITY COUNTY
34VA	LOUDOUN HOSPITAL CENTER HELIPORT
35D	PADGHAM FIELD
35ME	MATINICUS ISLAND ARPT
36U	HEBER CITY MUNI ARPT - RUSS MCDONALD FIELD
37KY	UK HOSPITAL HELIPORT
38TE	JOHN S DUNN HELISTOP
39N	PRINCETON ARPT
3A2	NEW TAZEWELL MUNICIPAL
3B0	SOUTHBRIDGE MUNICIPAL ARPT
3CK	LAKE IN THE HILLS
3CM	JAMES CLEMENTS MUNICIPAL ARPT
3D2	EPHRAIM- GIBRALTAR ARPT
3EX	EXCELSIOR SPRINGS MEM
3F7	JONES MEMORIAL
3FD1	TAMPA BAY EXECUTIVE -CLOSED
3FU	FAULKTON MUNICIPAL ARPT
3G9	BUTLER FARM SHOW
3GV	EAST KANSAS CITY ARPT
3I2	MASON COUNTY ARPT -WV
3LF	LITCHFIELD MUNICIPAL
3MY	MOUNT HAWLEY AUXILIARY ARPT
3R7	JENNINGS
3R9	LAKEWAY AIRPARK ARPT
3T0	CEDAR MILLS
3TR	JERRY TYLER MEMORIAL
3W2	PUT IN BAY
3W3	KENTMORR AIRPARK
3W9	MIDDLE BASS-EAST POINT
3XS2	CITIZENS MEDICAL CENTER HELIPORT
41AZ	AK CHIN COMMUNITY AIRFIELD
41C	CALKINS FIELD ARPT
42B	GOODSPEED
42PN	ALLEGHENY GEN HOSP EMERG HELIPORT
44G	BETZ ARPT
44N	SKY ACRES AIRPORT
45FA	HENDRY MEDICAL HELIPORT
45LA	AIR LOGICTICS N HELIPORT
46MO	SONTIMER ARPT
46N	SKY PARK
48D	CLARE MUNICIPAL ARPT
49B	STURGIS MUNICIPAL ARPT
4A7	CLAYTON COUNTY ARPT- TARA FIELD
4AC	CORONADO ARPT
4B0	SOUTH ALBANY ARPT
4B8	ROBERTSON FIELD
4D0	ABRAMS MUNICIPAL ARPT
4D1	THREE CASTLES ARPK
4G4	YOUNGSTOWN ELSER METRO
4G7	FAIRMONT MUNI-FRANKMAN FLD
4I3	KNOX COUNTY ARPT
4I9	MORROW COUNTY
4IA2	WALKER FIELD -IA
4KY7	MUELLER FARM ARPT
4LA4	CHEVRON USA INC HELIPORT
4LA6	LITTLE LAKE HELIPORT
4M1	CARROLL COUNTY ARPT
4M3	CARLISLE MUNICIPAL
4N1	GREENWOOD LAKE ARPT
4R9	DAUPHIN ISLAND ARPT
4TN4	COTTON FIELD ARPT
4V0	RANGLEY ARPT
4WI0	WISSOTA ARPT
4WI9	CORNELL MUNICIPAL ARPT
50R	LOCKHART MUNICIPAL ARPT
53OI	METRO HEALTH MEDICAL CENTER HELIPORT
54J	DEFUNIAK SPRINGS ARPT
56S	SEASIDE MUNICIPAL ARPT
57AZ	LA CHOLLA AIRPARK ARPT
57B	ISLESBORO
57D	RAY COMMUNITY ARPT
57Y	SANDSTONE MUNICIPAL ARPT
58KY	WILLOW ISLAND AIRPARK
59B	NEWTON FIELD ARPT
5A1	NORWALK-HURON COUNTY
5B2	SARATOGA COUNTY ARPT
5B6	FALMOUTH AIRPARK
5C1	BOERNE STAGE FIELD
5G8	GREENSBURG JEANETTE REGIONAL ARPT
5KE	KETCHIKAN HARBOR -SPB
5KY3	WEST KENTUCKY AIRPARK
5LA4	SHELL MORGAN CITY HELIPORT
5T6	DONA ANA COUNTY ARPT AT SANTA TERESA
5TS9	BIG DUKES PLACE
5W5	TRIPLE W ARPT
60F	SEYMOUR MUNICIPAL
61FL	TAMPA GENERAL HOSPITAL HELIPORT
61S	COTTAGE GROVE STATE ARPT
63C	ADAMS COUNTY- LEGION FIELD
64OG	ANTONE RANCH ARPT
65G	MAPLE GROVE ARPT
66R	ROBERT R WELLS JR ARPT
67S	PRIEST LAKE USFS
6A2	GRIFFIN-SPALDING CO
6B6	MINUTE MAN AIR FIELD
6B9	SKANEATELES AERO DROME
6D6	GREENVILLE MUNICIPAL
6D9	IOSCO COUNTY
6E5	WILDER ARPT
6G5	BARNESVILLE-BRADFIELD ARPT
6K5	SISTERS EAGLE
6L4	LOGAN COUNTY ARPT
6M2	HORSEHOE BEND ARPT
6N5	EAST 34TH STREET HELIPORT
6OI8	CLEVELAND CLINIC FOUNDATION HELIPORT
6PA6	AIR HAVEN ARPT
6S8	LAUREL MUNICIPAL
70N	SPRING HILL ARPT
70S	MEAD FLYING SERVICE ARPT
72F	THROCKMORTON MUNICIPAL
74S	ANACORTES
75MO	CHILDREN S MERCY HOSPITAL HELIPORT
77MI	DAVIDS ARPT
77S	HOBBY FIELD ARPT
79J	SOUTH ALABAMA REGNL ARPT AT BILL BENTON FIELD
7B2	NORTHAMPTON ARPT
7D5	PRIEBE ARPT
7D6	FREEDOM AIR FIELD
7FL6	SPRUCE CREEK ARPT
7K5	KENMARE MUNICIPAL ARPT
7LS1	PHI VENICE HELIPORT
7LS3	LAKE PALOURDE BASE HELIPORT
7LS4	PETROL HELI INTRACOASTAL CITY
7M3	BEARCE ARPT
7M4	OSCEOLA MUNICIPAL ARPT
7M6	PARIS MUNICIPAL
7MI3	THRALL LAKE ARPT
7S3	STARKS TWIN OAKS
7V2	NORTH FORK VALLEY
80D	CLARE COUNTY ARPT
81OK	TWIN LAKES RANCH ARPT
820H	COMMUNITY HOSPITAL OF WILLIAM CO HELIPORT
83D	MACKINAC COUNTY ARPT
87I	YAZOO COUNTY ARPT
87MO	RICHTERS ARPT
87Y	BLACKHAWK AIRFIELD
88R	SPICEWOOD ARPT
89D	KELLEYS ISLAND LAND FIELD ARPT
8A1	GUNTERSVILLE MUNI ARPT-JOE STARNES FIELD
8A4	INDIANAPOLIS DOWNTOWN HELIPORT
8A6	WILGROVE AIR PARK
8B8	LAKES REGIONAL ARPT
8D4	PAUL C. MILLER-SPARTA ARPT
8D7	CLARK COUNTY ARPT -SD
8LA1	CHEVRON USA INC SEAPLANE BASE
8S4	ENTERPRISE MUNICIPAL ARPT
8TN7	SHORT CREEK ARPT
8U2	SCHAFER/USFS
8W2	NEW MARKET
90WA	WALDRONAIRE ARPT
98D	ONIDA MUNICIPAL
99Y	GREELEY MUNICIPAL ARPT
9A7	SOUTH EXPRESSWAY
9B1	MARLBORO ARPT
9D2	HARDING COUNTY ARPT
9D4	DECK ARPT
9G0	BUFFALO AIRFIELD ARPT
9G2	PRICES ARPT
9N1	VANSANT
9WI8	FLETCHER ARPT
9Z4	INNER HARBOR -SPB
A29	SITKA -SPB
A63	TWIN HILLS ARPT
AK28	CHENA MARINA ARPT
AZ75	SUMMIT HEALTHCARE RGNL MED CENTER
C09	MORRIS MUNI ARPT - JAMES R. WASHBURN FIELD
C20	ANDREWS UNIV AIRPARK
C29	MIDDLETON MUNI ARPT - MOREY FIELD
C35	REEDSBURG MUNICIPAL
C43	HIRAM CURE ARPT
C47	PORTAGE MUNICIPAL ARPT
C62	KENDALLVILLE MUNICIPAL ARPT
C65	PLYMOUTH MUNICIPAL -IN
C66	MONMOUTH MUNICIPAL
C81	CAMPBELL ARPT
C91	DOWAGIAC MUNICIPAL ARPT
CA52	PORT OCALL HELIPORT
CA92	PARADISE SKYPARK ARPT
CKU	CORDOVA MUNICIPAL ARPT
CL33	PAUMA VALLEY AIR PARK ARPT
CO80	FOWLER ARPT
CO90	USAF ACADEMY BULLSEYE AUX AIRSTRIP
CT60	CANTERBURY FARM ARPT
CYAG	FORT FRANCES MUNICIPAL
CYEG	EDMONTON INTL
CYET	EDSON
CYGW	KUUJJUARAPIK
CYHM	HAMILTON
CYHU	SAINT HUBERT
CYHZ	HALIFAX INTL
CYJT	STEPHENVILLE
CYKF	KITCHENER/WATERLOO REGIONAL
CYKZ	TORONTO/BUTTONVILLE MUNICIPAL
CYLJ	MEADOW LAKE
CYMX	MONTREAL INTL -MIRABEL
CYOW	OTTAWA/MACDONALD-CARTIER INTL
CYQA	MUSKOKA
CYQB	QUEBEC/JEAN LESAGE INTL
CYQG	WINDSOR
CYQR	REGINA INTL
CYQT	THUNDER BAY
CYQX	GANDER INTL
CYSB	SUDBURY
CYSN	ST CATHARINES/NIAGARA DISTRICT
CYUL	MONTREAL/PIERRE-ELLIOTT-TRUDEAU INTL
CYVR	VANCOUVER INTL
CYWG	WINNIPEG INTL
CYWH	VICTORIA HARBOUR
CYXE	SASKATOON/JOHN G. DIEFENBAKER INTL
CYXU	LONDON
CYYC	CALGARY INTL
CYYJ	VICTORIA INTL
CYYR	GOOSE BAY
CYYT	ST. JOHNS INTL
CYYZ	TORONTO/LESTER B. PEARSON INTL
D00	NORMAN CO ADA/TWIN VALLEY
D09	BOTTINEAU MUNICIPAL ARPT
D25	MANITOWISH WATERS
D38	CANANDAIGUA ARPT
D68	SPRINGERVILLE MUNICIPAL
D73	MONROE-WALTON COUNTY
DAAG	HOUARI BOUMEDIENE
DNMM	MURTALA MUHAMMED
E16	SOUTH COUNTY ARPT OF SANTA CLARA COUNTY
E27	ELK GROVE ARPT
E38	ALPINE-CASPARIS MUNICIPAL
E45	PINE MOUNTAIN LAKE ARPT
E63	GILA BEND MUNICIPAL
E91	CHINLE MUNICIPAL ARPT
EBBR	BRUSSELS NATIONAL
EBLG	LIEGE ARPT
EBOS	OOSTTENDE
EDDF	FRANKFURT MAIN
EDDK	COLOGNE-BONN
EDDL	DUSSELDORF
EDDM	MUNICH INTL ARPT
EDDN	NURNBERG
EDDP	LEIPZIG-HALLE
EDDS	STUTTGART GERMANY
EDDT	BERLIN TEGEL
EFHK	HELSINKI-VANTAA ARPT
EGAA	BELFAST INTL ARPT
EGBB	BIRMINGHAM INTL
EGBE	COVENTRY ARPT
EGBJ	GLOUCESTERSHIRE ARPT
EGCC	MANCHESTER ENGLAND
EGGD	BRISTOL INTL
EGGW	LONDON-LUTON ARPT
EGHI	SOUTHAMPTON ARPT
EGJA	ALDERNEY ARPT
EGJB	GUERNSEY ARPT
EGJJ	JERSEY ARPT
EGKA	SHOREHAM ARPT
EGKB	BIGGIN HILL ARPT
EGKK	GATWICK - LONDON
EGLF	FARNBOROUGH ARPT
EGLK	BLACKBUSHE ARPT
EGLL	HEATHROW - LONDON
EGLS	OLD SARUM AIRFIELD
EGMD	LONDON ASHFORD ARPT
EGNJ	HUMBERSIDE
EGNX	EAST MIDLANDS
EGPE	INVERNESS ARPT
EGPH	EDINBURGH ARPT
EGPK	PRESTWICK
EGSS	STANSTEAD-LONDON
EGSX	NORTH WEALD AIRFIELD
EGTO	ROCHESTER ARPT
EHAM	AMSTERDAM SCHIPHOL
EIDW	DUBLIN INTL ARPT
EINN	SHANNON INTL
EKCH	KASTRUP AIRPORT
ELLX	LUXEMBOURG INTL ARPT
ENFB	FORNEBU -OSLO
ESMS	MALMO-STURUP ARPT
ESSA	STOCKHOLM ARLANDA SWEDEN
ETAR	RAMSTEIN AIR FORCE BASE
F10	HENRYETTA MUNICIPAL ARPT
F22	PERRY MUNICIPAL ARPT
F31	LAKE TEXOMA STATE PARK ARPT
F35	POSSUM KINGDOM ARPT
F45	NORTH PALM BEACH CNTY GEN AVTN
F62	HAYFORK ARPT
F72	FRANKLIN FIELD ARPT
F87	UNION PARISH ARPT
FA40	HIDDEN LAKE ARPT
FA61	SHANDS JACKSONVILLE HOSPITAL HELIPORT
FA81	TAVERNAERO PARK
FACT	CAPE TOWN INTL ARPT
FL17	RUCKEL AIRPORT
FL59	BUCKINGHAM FIELD ARPT
FWKI	KAMUZU INTL
G05	FINLEYVILLE AIRPARK
GA04	MALLARDS LANDING
GMME	RABAT MOROCCO
GOOY	DAKAY-YOFF-LEOPOLD SEDAR SENGHOR
H2O	REMOTE_WATER
H34	HUNTSVILLE-MADISON
H68	HEFNER-EASLEY AIRSTRIP
H71	MID-AMERICA INDUSTRIAL
H75	HERNANDO VILLAGE ARPK
HECA	CAIRO INTL
HI01	PRINCEVILLE ARPT
HKJK	NAIROBI JOMO KENYATA
I18	JACKSON COUNTY ARPT
I19	GREEN COUNTY-LEWIS A. JACKSON REGNL ARPT
I23	FAYETTE COUNTY ARPT
I39	MADISON ARPT
I40	RICHARD DOWNING
I41	ROBERT NEWLON FIELD
I62	BROOKVILLE AIR-PARK
I64	WAKEMAN ARPT
I66	CLINTON FIELD ARPT
I68	LEBANON-WARREN COUNTY ARPT
I69	CLERMONT COUNTY ARPT
I95	HARDIN COUNTY
IA24	GREEN CASTLE ARPT
IA66	NASH FIELD INDIANOLA -PVT
K15	GRND GLAIZE-OSAGE BEACH
K38	WASHINGTON COUNTY MEMORIAL
K81	MIAMI COUNTY ARPT
KAAF	APALACHICOLA REGIONAL ARPT
KAAO	COLONEL JAMES JABARA ARPT
KABE	LEHIGH VALLEY INTL
KABI	ABILENE REGIONAL ARPT
KABQ	ALBUQUERQUE INTL SUNPORT
KABR	ABERDEEN REGIONAL ARPT
KABY	SOUTHWEST GEORGIA REGIONAL ARPT
KACB	ANTRIM COUNTY ARPT
KACK	NANTUCKET MEMORIAL
KACT	WACO REGIONAL ARPT
KACV	ARCATA AIRPORT
KACY	ATLANTIC CITY INTL
KADC	WADENA MUNICIPAL
KADF	DEXTER B FLORENCE MEMORIAL FIELD ARPT
KADG	LENAWEE COUNTY ARPT
KADH	ADA MUNICIPAL ARPT
KADM	ARDMORE MUNICIPAL
KADS	ADDISON
KADW	JOINT BASE ANDREWS
KAEG	DOUBLE EAGLE II ARPT
KAEL	ALBERT LEA MUNICIPAL ARPT
KAEX	ALEXANDRIA INTL
KAFJ	WASHINGTON COUNTY
KAFW	FORT WORTH ALLIANCE
KAGC	ALLEGHENY COUNTY ARPT
KAGO	MAGNOLIA MUNICIPAL
KAGS	AUGUSTA REGIONAL ARPT AT BUSH FLD
KAHN	ATHENS/BEN EPPS ARPT
KAIA	ALLIANCE MUNICIPAL ARPT
KAID	ANDERSON MUNI-DARLINGTON FLD
KAIZ	LEE C FINE MEMORIAL ARPT
KALB	ALBANY INTL
KALN	ST LOUIS REGIONAL
KALO	WATERLOO REGIONAL ARPT
KALS	SAN LUIS VALLEY REGNL ARPT/BERGMAN FIELD
KALW	WALLA WALLA REGIONAL
KALX	THOMAS RUSSELL FIELD
KAMA	RICK HUSBAND AMARILLO INTL
KAMN	GRATIOT COMMUNITY
KANB	ANNISTON METROPOLITAN ARPT
KAND	ANDERSON REGIONAL
KANE	ANOKA COUNTY-BLAINE
KANJ	SAULT STE MARIE MUNICIPAL
KANQ	TRI-STATE STEUBEN COUNTY ARPT
KAOH	LIMA ALLEN COUNTY
KAOO	ALTOONA-BLAIR COUNTY
KAPA	CENTENNIAL ARPT
KAPC	NAPA COUNTY ARPT
KAPF	NAPLES MUNICIPAL
KAPN	ALPENA COUNTY REG
KAPT	MARION COUNTY-BROWN FIELD
KAQO	LLANO MUNICIPAL ARPT
KARA	ACADIANA REGIONAL ARPT
KARB	ANN ARBOR MUNICIPAL
KARG	WALNUT RIDGE REGIONAL ARPT
KARR	AURORA MUNICIPAL ARPT
KART	WATERTOWN INTL ARPT
KARV	LAKELAND ARPT/NOBLE F. LEE MEMORIAL FIELD
KARW	BEAUFORT COUNTY ARPT
KASD	SLIDELL AIRPORT
KASE	ASPEN-PITKIN COUNTY ARPT/SARDY FIELD
KASG	SPRINGDALE MUNICIPAL ARPT
KASH	BOIRE FIELD
KASL	HARRISON COUNTY ARPT
KAST	ASTORIA REGIONAL
KASW	WARSAW MUNICIPAL -IN
KASX	JOHN F KENNEDY MEMORIAL
KATL	HARTSFIELD - JACKSON ATLANTA INTL ARPT
KATW	OUTAGAMIE COUNTY REGIONAL
KATY	WATERTOWN REGIONAL ARPT
KAUG	AUGUSTA STATE
KAUM	AUSTIN MUNICIPAL
KAUN	AUBURN MUNICIPAL -CA
KAUO	AUBURN-OPELIKA RG PITTS
KAUS	AUSTIN-BERGSTROM INTL
KAUW	WAUSAU DOWNTOWN ARPT
KAVC	MECKLENBURG-BRUNSWICK REGIONAL
KAVL	ASHEVILLE REGIONAL ARPT
KAVP	WILKES-BARRE/SCRANTON INTL
KAVQ	MARANA REGIONAL ARPT
KAWO	ARLINGTON MUNICIPAL ARPT -WA
KAXH	HOUSTON-SOUTHWEST ARPT
KAXN	CHANDLER FIELD ARPT
KAXS	ALTUS/QUARTZ MOUNTAIN RGNL ARPT
KAZO	KALAMAZOO/BATTLE CREEK INTL
KB10	BOWMAN FIELD ARPT
KB19	BIDDEFORD MUNICIPAL
KBAD	BARKSDALE AIR FORCE BASE ARPT
KBAF	BARNES MUNICIPAL ARPT
KBAK	COLUMBUS MUNICIPAL ARPT -IN
KBAX	HURON COUNTY MEMORIAL
KBAZ	NEW BRAUNFELS MUNICIPAL ARPT
KBBG	BRANSON ARPT
KBCB	VIRGINIA TECH/MONTGOMERY EXEC ARPT
KBCT	BOCA RATON ARPT
KBDE	BAUDETTE INTL ARPT
KBDG	BLANDING MUNICIPAL
KBDH	WILLMAR MUNI ARPT-JOHN L RICE FIELD
KBDL	BRADLEY INTL
KBDR	IGOR I SIKORSKY MEMORIAL
KBDU	BOULDER MUNICIPAL
KBEC	BEECH FACTORY ARPT
KBED	LAURENCE G HANSCOM FIELD ARPT
KBEH	SOUTHWEST MICHIGAN REGIONAL
KBFD	BRADFORD REGIONAL
KBFF	WESTERN NEBRASKA REGNL ARPT/WILLIAM B. HEILIG FIELD
KBFI	BOEING FIELD/KING COUNTY INTL ARPT
KBFL	MEADOWS FIELD ARPT
KBFM	MOBILE DOWNTOWN ARPT
KBFR	VIRGIL I GRISSOM MUNICIPAL
KBGE	DECATUR COUNTY INDUSTRIAL AIR PARK
KBGM	GREATER BINGHAMTON ARPT/EDWIN A LINK FIELD
KBGR	BANGOR INTL
KBHB	HANCOCK COUNTY-BAR HARBOR
KBHM	BIRMINGHAM-SHUTTLESWORTH INTL
KBID	BLOCK ISLAND STATE
KBIL	BILLINGS LOGAN INTL
KBIS	BISMARCK MUNICIPAL ARPT
KBIV	TULIP CITY ARPT
KBJC	ROCKY MOUNTAIN METROPOLITAN ARPT
KBJI	BEMIDJI REGIONAL ARPT
KBJJ	WAYNE COUNTY
KBKF	BUCKLEY ANGB ARPT
KBKL	BURKE LAKEFRONT
KBKN	BLACKWELL-TONKAWA MUNICIPAL
KBKS	BROOKS COUNTY
KBKV	BROOKSVILLE-TAMPA BAY REGNL ARPT
KBKW	RALEIGH COUNTY MEMORIAL
KBKX	BROOKINGS REGIONAL ARPT
KBLI	BELLINGHAM INTL
KBLM	MONMOUTH EXECUTIVE ARPT
KBLV	SCOTT AFB/MIDAMERICA ARPT
KBMC	BRIGHAM CITY ARPT
KBMG	MONROE COUNTY
KBMI	CENTRAL ILLINOIS REGNL ARPT AT BLOOMINGTON-NORMAL
KBML	BERLIN REGIONAL ARPT
KBNA	NASHVILLE INTL
KBNO	BURNS MUNICIPAL AIRPORT
KBOI	BOISE AIR TERMINAL/GOWEN FIELD
KBOS	GENERAL EDWARD LAWRENCE LOGAN INTL ARPT
KBOW	BARTOW MUNICIPAL
KBPG	BIG SPRING MCMAHON-WRINKLE ARPT
KBPI	MILEY MEMORIAL FIELD ARPT
KBPT	JACK BROOKS REGIONAL ARPT
KBQK	BRUNSWICK GOLDEN ISLES
KBRD	BRAINERD LAKES REGIONAL ARPT
KBRL	SOUTHEAST IOWA REGIONAL ARPT
KBRO	BROWNSVILLE/SOUTH PADRE ISLAND INTL ARPT
KBTF	BOUNTIFUL SKYPARK
KBTL	W K KELLOGG ARPT
KBTM	BERT MOONEY
KBTN	BRITTON MUNICIPAL ARPT SD
KBTR	BATON ROUGE METROPOLITAN, RYAN FIELD
KBTV	BURLINGTON INTL
KBUF	BUFFALO-NIAGARA INTL
KBUR	BOB HOPE ARPT
KBUY	BURLINGTON-ALAMANCE REGIONAL
KBVI	BEAVER COUNTY ARPT
KBVO	BARTLESVILLE MUNICIPAL ARPT
KBVS	SKAGIT REGIONAL
KBVU	BOULDER CITY MUNICIPAL ARPT
KBVY	BEVERLY MUNICIPAL ARPT
KBWC	BRAWLEY MUNICIPAL
KBWD	BROWNWOOD REGIONAL ARPT
KBWG	BOWLING GREEN-WARREN COUNTY REGNL ARPT
KBWI	BALTIMORE/WASH INTL THURGOOD MARSHAL ARPT
KBXA	GEORGE R CARR MEMORIAL
KBXK	BUCKEYE MUNICIPAL ARPT
KBYH	ARKANSAS INTERNATIONAL ARPT
KBYI	BURLEY MUNICIPAL AIRPORT
KBZN	GALLATIN FIELD ARPT
KCAE	COLUMBIA METRO
KCAK	AKRON-CANTON REGIONAL
KCBE	GRTR CUMBERLAND REGIONAL
KCBF	COUNCIL BLUFFS MUNICIPAL ARPT
KCBK	SHALZ FIELD ARPT
KCCR	BUCHANAN FIELD ARPT
KCDC	CEDAR CITY REGIONAL
KCDI	CAMBRIDGE MUNICIPAL
KCDR	CHADRON MUNICIPAL ARPT
KCDW	ESSEX COUNTY AIRPORT
KCEC	JACK MCNAMARA FIELD ARPT
KCEF	WESTOVER AIR RESERVE BASE/METROPOLITAN ARPT
KCEU	OCONEE COUNTY REGIONAL ARPT
KCEV	METTEL FIELD ARPT
KCEW	BOB SIKES ARPT
KCEZ	CORTEZ MUNICIPAL ARPT
KCFJ	CRAWFORDSVILLE MUNI ARPT
KCGC	CRYSTAL RIVER AIRPORT
KCGE	CAMBRIDGE-DORCHESTER ARPT
KCGF	CUYAHOGA COUNTY ARPT
KCGI	CAPE GIRARDEAU REGIONAL ARPT
KCGS	COLLEGE PARK ARPT
KCGX	MERRILL C MEIGS ARPT
KCHA	LOVELL FIELD ARPT
KCHD	CHANDLER MUNICIPAL ARPT
KCHO	CHARLOTTESVILLE-ALBEMARLE ARPT
KCHS	CHARLESTON AFB/INTL ARPT
KCHT	CHILLICOTHE MUNICIPAL ARPT
KCIC	CHICO MUNICIPAL ARPT
KCID	THE EASTERN IOWA ARPT
KCIU	CHIPPEWA COUNTY INTL ARPT
KCJR	CULPEPER REGIONAL ARPT
KCKB	NORTH CENTRAL WEST VIRGINIA ARPT
KCKN	CROOKSTON MUNI ARPT-KIRKWOOD FIELD
KCKP	CHEROKEE COUNTY REGIONAL ARPT
KCKV	OUTLAW FIELD ARPT
KCLE	CLEVELAND-HOPKINS INTL ARPT
KCLI	CLINTONVILLE MUNICIPAL ARPT
KCLL	EASTERWOOD FIELD AIRPORT
KCLM	WILLIAM R FAIRCHILD INTL ARPT
KCLS	CHEHALIS-CENTRALIA ARPT
KCLT	CHARLOTTE/DOUGLAS INTL ARPT
KCLW	CLEARWATER AIR PARK
KCMA	CAMARILLO
KCMD	CULLMAN REGIONAL ARPT-FOLSOM FIELD
KCMH	PORT COLUMBUS INTL
KCMI	UNIV OF ILLINOIS -WILLARD ARPT
KCMX	HOUGHTON COUNTY MEM
KCNH	CLAREMONT MUNICIPAL ARPT
KCNM	CAVERN CITY AIR TERMINAL
KCNO	CHINO AIRPORT
KCNW	TSTC WACO
KCNY	CANYONLANDS FIELD
KCOD	YELLOWSTONE REGIONAL
KCOE	COEUR DALENE ARPT-PAPPY BOYINGTON FIELD
KCOF	PATRICK AIR FORCE BASE
KCOI	MERRIT ISLAND ARPT
KCOS	CITY OF COLORADO SPRINGS MUNI APRT
KCOU	COLUMBIA REGIONAL
KCPM	COMPTON/WOODLEY ARPT
KCPR	CASPER/NATRONA COUNTY INTL ARPT
KCPS	ST LOUIS DOWNTOWN
KCPT	CLEBURNE REGIONAL ARPT
KCQF	H L SONNY CALLAHAN ARPT
KCQX	CHATHAM MUNICIPAL ARPT
KCRE	GRAND STRAND ARPT
KCRG	CRAIG MUNICIPAL ARPT
KCRP	CORPUS CHRISTI INTL ARPT
KCRQ	MC CLELLAN-PALOMAR ARPT
KCRS	C DAVID DAMPBELL FIELD-CORSICANA MUNI ARPT
KCRW	YEAGER ARPT
KCRZ	CORNING MUNICIPAL ARPT -IA
KCSG	COLUMBUS ARPT
KCSM	CLINTON-SHERMAN ARPT
KCSV	CROSSVILLE MEMORIAL ARPT/WHITSON FIELD
KCTB	CUT BANK MUNICIPAL ARPT
KCTJ	WEST GEORGIA REGNL ARPT-O V GRAY FIELD
KCTY	CROSS CITY ARPT
KCUB	JIM HAMILTON L B OWENS ARPT
KCUT	CUSTER COUNTY ARPT
KCVC	COVINGTON MUNICIPAL ARPT
KCVG	CINCINNATI/NORTHERN KENTUCKY INTL ARPT
KCVN	CLOVIS MUNICIPAL ARPT
KCVO	CORVALLIS MUNICIPAL ARPT
KCWA	CENTRAL WISCONSIN ARPT
KCWC	KICKAPOO DOWNTOWN ARPT
KCWF	CHENNAULT INTL ARPT
KCWS	DENNIS F CANTRELL FIELD ARPT
KCWV	CLAXTON-EVANS COUNTY ARPT
KCXO	LONE STAR EXECUTIVE ARPT
KCXP	CARSON ARPT
KCXY	CAPITAL CITY ARPT -PA
KCYO	PICKAWAY COUNTY MEMORIAL ARPT
KCYS	CHEYENNE REGIONAL ARPT/JERRY OLSON FIELD
KDAB	DAYTONA BEACH INTL
KDAG	BARSTOW-DAGGETT ARPT
KDAL	DALLAS LOVE FIELD ARPT
KDAN	DANVILLE REGIONAL ARPT
KDAY	JAMES M COX DAYTON INTL
KDBN	W H BUD BARRON ARPT
KDBQ	DUBUQUE REGIONAL ARPT
KDCA	RONALD REAGAN WASHINGTON NATIONAL ARPT
KDCU	PRYOR FIELD REGIONAL ARPT
KDDC	DODGE CITY REGIONAL ARPT
KDEC	DECATUR ARPT
KDED	DELAND MUNICIPAL ARPT-SIDNEY H TAYLOR FIELD
KDEN	DENVER INTL AIRPORT
KDEN*	DENVER STAPLETON ARPT
KDET	COLEMAN A YOUNG MUNICIPAL ARPT
KDEW	DEER PARK ARPT
KDFW	DALLAS/FORT WORTH INTL ARPT
KDGW	CONVERSE COUNTY ARPT
KDHN	DOTHAN REGIONAL ARPT
KDIJ	DRIGGS-REED MEMORIAL ARPT
KDIK	DICKINSON-THEODORE ROOSEVELT RGNL
KDKB	DE KALB TAYLOR MUNICIPAL ARPT
KDKK	CHAUTAUQUA COUNTY/DUNKIRK ARPT
KDKX	KNOXVILLE DOWNTOWN ISLAND ARPT
KDLH	DULUTH INTL ARPT
KDLL	BARABOO WISCONSIN DELLS ARPT
KDLS	COLUMBIA GORGE REGNL /THE DALLES MUNI ARPT
KDLZ	DELAWARE MUNICIPAL ARPT-JIM MOORE FIELD
KDMA	DAVIS MONTHAN AIR FORCE BASE
KDMN	DEMING MUNICIPAL ARPT
KDMW	CARROLL COUNTY REGNL ARPT/JACK B POAGE FIELD
KDNL	DANIEL FIELD ARPT
KDNS	DENISON MUNICIPAL ARPT
KDNV	VERMILION REGIONAL ARPT
KDOV	DOVER AIR FORCE BASE
KDPA	DUPAGE AIRPORT
KDRI	BEAUREGARD REGIONAL ARPT
KDRM	DRUMMOND ISLAND ARPT
KDRO	DURANGO-LA PLATA COUNTY ARPT
KDRT	DEL RIO INTL ARPT
KDSM	DES MOINES INTL
KDTL	DETROIT LAKES ARPT - WETHING FLD
KDTN	SHREVEPORT DOWNTOWN ARPT
KDTO	DENTON MUNICIPAL ARPT
KDTS	DESTIN-FORT WALTON BEACH ARPT
KDTW	DETROIT METRO WAYNE COUNTY ARPT
KDUG	BISBEE DOUGLAS INTL ARPT
KDUH	TOLEDO SUBURBAN ARPT
KDUJ	DUBOIS REGIONAL ARPT
KDVL	DEVILS LAKE REGIONAL ARPT
KDVO	GNOSS FIELD ARPT
KDVT	PHOENIX DEER VALLEY ARPT
KDWA	YOLO COUNTY ARPT
KDWH	DAVID WAYNE HOOKS MEMORIAL ARPT
KDWX	DIXON ARPT
KDXR	DANBURY MUNICIPAL ARPT
KDYA	DEMOPOLIS MUNICIPAL ARPT
KDYR	DYERSBURG REGIONAL ARPT
KDYT	SKY HARBOR
KDZB	HORSESHOE BAY RESORT ARPT
KEAR	KEARNEY REGIONAL ARPT
KEAT	PANGBORN MEMORIAL
KEAU	CHIPPEWA VALLEY REGIONAL ARPT
KECG	ELIZABETH CITY CGAS/REGIONAL ARPT
KECP	NORTHWEST FLORIDA BEACHES INTL
KEDC	AUSTIN EXECUTIVE ARPT
KEDE	NORTHEASTERN REGIONAL
KEDU	UNIVERSITY ARPT
KEDW	EDWARDS AIR FORCE BASE
KEEN	DILLANT-HOPKINS ARPT
KEFD	ELLINGTON FIELD ARPT
KEGE	EAGLE COUNTY REGIONAL
KEHA	ELKHART-MORTON COUNTY ARPT
KEHR	HENDERSON CITY-COUNTY ARPT
KEKA	MURRAY FIELD AIRPORT
KEKM	ELKHART MUNICIPAL ARPT
KEKO	ELKO REGIONAL ARPT
KEKX	ADDINGTON FIELD ARPT
KEKY	BESSEMER ARPT
KELM	ELMIRA/CORNING REGIONAL ARPT
KELP	EL PASO INTL ARPT
KELY	ELY AIRPORT/YELLAND FIELD
KEMT	EL MONTE ARPT
KENV	WENDOVER ARPT
KENW	KENOSHA REGIONAL ARPT
KEOK	KEOKUK MUNICIPAL ARPT
KEOP	PIKE COUNTY ARPT
KEOS	NEOSHO HUGH ROBINSON ARPT
KEQA	ELDORADO/CAPTAIN JACK THOMAS MEMORIAL ARPT
KEQY	CHARLOTTE-MONROE  EXECUTIVE ARPT
KERI	ERIE INTL ARPT-TOM RIDGE FIELD
KERR	ERROL ARPT
KERV	KERVILLE MUNI ARPT/LOUIS SCHREINER FIELD
KESC	DELTA COUNTY ARPT
KESF	ESLER REGIONAL ARPT
KESN	EASTON/NEWNAM FIELD ARPT
KEST	ESTHERVILLE MUNICIPAL ARPT
KETB	WEST BEND MUNICIPAL ARPT
KEUF	WEEDON FIELD ARPT
KEUG	MAHLON SWEET FLD
KEVB	NEW SMYRNA BEACH MUNICIPAL ARPT
KEVV	EVANSVILLE REGIONAL
KEVW	EVANSTON-UINTA COUNTY BURNS FIELD
KEVY	SUMMIT AIRPORT
KEWB	NEW BEDFORD REGIONAL ARPT
KEWK	NEWTON CITY/COUNTY ARPT
KEWN	COASTAL CAROLINA REGIONAL ARPT
KEWR	NEWARK LIBERTY INTL ARPT
KEXX	DAVIDSON COUNTY ARPT
KEYE	EAGLE CREEK AIRPARK
KEYW	KEY WEST INTL ARPT
KEZF	SHANNON AIRPORT
KEZM	HEART OF GEORGIA REGIONAL ARPT
KEZS	SHAWANO MUNICIPAL ARPT
KFAM	FARMINGTON REGIONAL
KFAR	HECTOR INTERNATIONAL
KFAT	FRESNO YOSEMITE INTL
KFAY	FAYETTVILLE REGNL ARPT/GRANNIS FIELD
KFCI	CHESTERFIELD COUNTY ARPT
KFCM	FLYING CLOUD ARPT
KFDK	FREDERICK MUNICIPAL ARPT
KFDR	FREDERICK REGIONAL ARPT
KFDW	FARIFIELD COUNTY ARPT
KFDY	FINDLAY ARPT
KFES	FESTUS MEMORIAL ARPT
KFFA	FIRST FLIGHT
KFFC	ATLANTA REGIONAL ARPT - FALCON FIELD
KFFM	FERGUS FALLS MUNI ARPT-EINAR MICKELSON FIELD
KFFO	WRIGHT-PATTERSON AIR FORCE BASE
KFFZ	FALCON FIELD ARPT
KFHB	FERANDINA BEACH MUNICIPAL ARPT
KFHR	FRIDAY HARBOR ARPT
KFHU	SIERRA VISTA MUNI ARPT-LIBBY ARMY AIRFIELD
KFIN	FLAGLER COUNTY ARPT
KFIT	FITCHBURG  MUNICIPAL ARPT
KFKL	VENANGO REGIONAL
KFLD	FOND DU LAC COUNTY ARPT
KFLG	FLAGSTAFF PULLIAM
KFLL	FORT LAUDERDALE/HOLLYWOOD INTL
KFLO	FLORENCE REGIONAL
KFLP	MARION COUNTY REGIONAL ARPT
KFLV	SHERMAN ARMY AIRFIELD
KFLY	MEADOW LAKE ARPT
KFME	TIPTON ARPT
KFMH	CAPE COD COAST GUARD AIR STATION
KFMN	FOUR CORNERS REGIONAL
KFMY	PAGE FIELD ARPT
KFNB	BRENNER FIELD ARPT
KFNL	FORT COLLINS-LOVELAND MUNI ARPT
KFNT	BISHOP INTL ARPT
KFOD	FORT DODGE REGIONAL
KFOE	FORBES FIELD AIRPORT
KFOK	FRANCIS S GABRESKI ARPT
KFPK	FITCH H BEACH ARPT
KFPR	ST. LUCIE COUNTY INTL ARPT
KFRG	REPUBLIC AIRPORT
KFRH	FRENCH LICK MUNICIPAL ARPT
KFRM	FAIRMONT MUNICIPAL ARPT
KFSD	JOE FOSS FIELD ARPT
KFSM	FORT SMITH REGIONAL ARPT
KFSU	FORT SUMNER MUNICIPAL ARPT
KFTG	FRONT RANGE ARPT
KFTW	FORT WORTH MEACHAM INTL ARPT
KFTY	FULTON COUNTY ARPT - BROWN FIELD
KFUL	FULLERTON MUNICIPAL ARPT
KFVX	FARMVILLE REGIONAL ARPT
KFWA	FORT WAYNE INTL
KFWQ	ROSTRAVER
KFWS	FORT WORTH SPINKS ARPT
KFXE	FORT LAUDERDALE EXECUTIVE ARPT
KFYJ	MIDDLE PENINSULA REGIONAL ARPT
KFYV	DRAKE FIELD ARPT
KFZY	OSWEGO COUNTY
KGAD	NORTHEAST ALABAMA REGIONAL ARPT
KGAF	HUTSON FIELD ARPT
KGAI	MONTGOMERY CO AIRPARK
KGAO	SOUTH LAFOURCHE LEONARD MILLER  JR ARPT
KGAS	GALLIA-MEIGS REGIONAL ARPT
KGBD	GREAT BENT MUNICIPAL
KGCC	GILLETTE-CAMPBELL COUNTY ARPT
KGCD	GRANT COUNTY REGNL ARPT/OGILVIE FIELD
KGCK	GARDEN CITY REGIONAL
KGCN	GRAND CANYON NATIONAL
KGDB	GRANITE FALLS MUNICIPAL ARPT
KGDV	DAWSON COMMUNITY ARPT
KGED	SUSSEX COUNTY ARPT
KGEG	SPOKANE INTERNATIONAL
KGEU	GLENDALE MUNICIPAL ARPT
KGEV	ASHE COUNTY
KGFK	GRAND FORKS INTL
KGFL	FLOYD BENNETT MEMORIAL
KGGE	GEORGETOWN COUNTY ARPT
KGGG	EAST TEXAS REGIONAL ARPT
KGGW	WOKAL FIELD/GLASGOW INTL ARPT
KGHG	MARSHFIELD MUNI ARPT-GEORGE HARLOW FIELD
KGHM	CENTERVILLE MUNICIPAL ARPT
KGHW	GLENWOOD MUNICIPAL ARPT
KGIC	IDAHO COUNTY ARPT
KGIF	WINTER HAVENS GILBERT ARPT
KGJT	GRAND JUNCTION REGIONAL ARPT
KGKJ	PORT MEADVILLE ARPT
KGKY	ARLINGTON MUNICIPAL ARPT -TX
KGLD	RENNER FLD/GOODLAND MUNI ARPT
KGLE	GAINESVILLE MUNICIPAL ARPT
KGLH	GREENVILLE MID-DELTA ARPT
KGLR	GAYLORD REGIONAL ARPT
KGLS	SCHOLES INTL ARPT AT GALVESTON
KGLW	GLASGOW MUNICIPAL ARPT
KGMU	GREENVILLE DOWNTOWN ARPT
KGNF	GRENADA MUNICIPAL ARPT
KGNT	GRANT-MILAN MUNI ARPT
KGNV	GAINESVILLE REG ARPT
KGON	GROTON-NEW LONDON AR
KGOO	NEVADA COUNTY AIR PARK
KGPH	MIDWEST NATIONAL AIR CENTER ARPT
KGPI	GLACIER PARK INTL
KGPT	GULFPORT-BILOXI INTL APRT
KGPZ	GRAND RAPIDS/ITASCA COUNTY ARPT-GORDON NEWSTROM FIELD
KGRB	AUSTIN STRAUBEL INTL
KGRD	GREENWOOD COUNTY ARPT
KGRI	CENTRAL NEBRASKA REGIONAL
KGRK	KILLEEN/FT HOOD REGIONAL
KGRR	GERALD R. FORD INTL ARPT
KGSH	GOSHEN MUNICIPAL ARPT
KGSO	PIEDMONT TRIAD INTL
KGSP	GREENVILLE-SPARTANBURG INTL
KGTB	WHEELER-SACK ARMY AIRFIELD
KGTE	QUINN FIELD ARPT
KGTF	GREAT FALLS INTL
KGTR	GOLDEN TRIANGLE REGIONAL
KGTU	GEORGETOWN MUNICIPAL ARPT
KGUC	GUNNISON-CRESTED BUTTE REGNL ARPT
KGUY	GUYMON MUNICIPAL ARPT
KGVL	LEE GILMER MEMORIAL ARPT
KGVQ	GENESEE COUNTY ARPT
KGVT	MAJORS ARPT
KGVW	RICHARDS-GEBAUR AFB
KGWB	DE KALB COUNTY ARPT
KGWO	GREENWOOD-LEFLORE ARPT
KGWR	GWINNER-ROGER MELROE FIELD ARPT
KGXY	GREELEY-WELD COUNTY ARPT
KGYH	DONALDSON CENTER ARPT
KGYI	NORTH TEXAS REGNL ARPT/PERRIN FIELD
KGYR	PHOENIX GOODYEAR ARPT
KGYY	GARY/CHICAGO INTL ARPT
KHAF	HALF MOON BAY
KHAI	THREE RIVERS MUNICIPAL ARPT
KHAO	BUTLER COUNTY REGIONAL
KHBV	JIM HOGG COUNTY ARPT
KHBZ	HEBER SPRINGS MUNICIPAL ARPT
KHCD	HUTCHINSON MUNICIPAL-BUTLER FLD
KHDC	HAMMOND NORTHSHORE REGIONAL ARPT
KHDN	YAMPA VALLEY
KHEF	MANASSAS REGNL ARPT/HARRY P. DAVIS FIELD
KHEG	HERLONG RECREATIONAL ARPT
KHEZ	HARDY-ANDERS FLD NATCHEZ-ADAMS CNTY
KHFD	HARTFORD-BRAINARD ARPT
KHFJ	MONETT MUNICIPAL ARPT
KHFY	GREENWOOD MUNICIPAL ARPT
KHGR	HAGERSTOWN REGNL ARPT-RICHARD A HENSON FIELD
KHHR	JACK NORTHROP FIELD/HAWTHORNE MUNI ARPT
KHIB	RANGE REGIONAL ARPT
KHIE	MOUNT WASHINGTON RGNL ARPT
KHIF	HILL AIR FORCE BASE
KHIG	HIGGINSVILLE INDUSTRIAL MUNICIPAL ARPT
KHII	LAKE HAVASU CITY ARPT
KHIO	PORTLAND-HILLSBORO ARPT
KHKA	BLYTHEVILLE MUNICIPAL ARPT
KHKS	HAWKINS FIELD ARPT
KHKY	HICKORY REGIONAL ARPT
KHLG	WHEELING OHIO COUNTY ARPT
KHLN	HELENA REGIONAL
KHMT	HEMET-RYAN ARPT
KHNB	HUNTINGBURG ARPT
KHOB	LEA COUNTY REGIONAL ARPT
KHON	HURON REGIONAL ARPT
KHOT	MEMORIAL FIELD
KHOU	WILLIAM P HOBBY ARPT
KHPN	WESTCHESTER COUNTY ARPT
KHQM	BOWERMAN ARPT
KHQU	THOMSON-MCDUFFIE COUNTY ARPT
KHQZ	MESQUITE METRO ARPT
KHRL	VALLEY INTL
KHRO	BOONE COUNTY ARPT
KHSA	STENNIS INTL ARPT
KHSD	SUNDANCE AIRPARK
KHST	HOMESTEAD AIR RESERVE BASE
KHSV	HUNTSVILLE INTL ARPT-CARL T JONES FIELD
KHTO	EAST HAMPTON ARPT
KHTS	TRI-STATE ARPT/MILTON J. FERGUSON FIELD
KHUA	REDSTONE ARMY AIRFIELD
KHUF	TERRE HAUTE INTL ARPT-HULMAN FIELD
KHUM	HOUMA-TERREBONNE ARPT
KHUT	HUTCHINSON MUNICIPAL
KHVN	TWEED-NEW HAVEN ARPT
KHVR	HAVRE CITY-COUNTY ARPT
KHWD	HAYWARD EXECUTIVE ARPT
KHWO	NORTH PERRY ARPT
KHWY	WARRENTON-FAUQUIER
KHXD	HILTON HEAD ISLAND
KHYA	BARNSTABLE MUNI ARPT-BOARDMAN/POLANDO FLD
KHYI	SAN MARCOS MUNICIPAL ARPT
KHYR	SAWYER COUNTY ARPT
KHYS	HAYS REGIONAL
KHZY	NORTHEAST OHIO REGIONAL ARPT
KIAB	MCCONNELL AIR FORCE BASE
KIAD	WASHINGTON DULLES INTL ARPT
KIAG	NIAGARA FALLS INTL
KIAH	GEORGE BUSH INTERCONTINENTAL/ HOUSTON ARPT
KICL	SCHENCK FIELD ARPT
KICT	WICHITA DWIGHT D EISENHOWER NATL ARPT
KIDA	IDAHO FALLS REGIONAL ARPT
KIDP	INDEPENDENCE MUNICIPAL ARPT
KIFA	IOWA FALLS MUNICIPAL ARPT
KIFP	LAUGHLIN/BULLHEAD INTL ARPT
KIGM	KINGMAN
KIGQ	LANSING MUNICIPAL ARPT
KIGX	HORACE WILLIAMS ARPT
KIJD	WINDHAM ARPT
KIKG	KLEBERG COUNTY ARPT
KIKK	GREATER KANKAKEE ARPT
KIKV	ANKENY REGIONAL
KIKW	JACK BARSTOW
KILE	SKYLARK FIELD
KILG	NEW CASTLE COUNTY
KILL	WILLMAR MUNICIPAL-J RICE
KILM	WILMINGTON INTL
KILN	WILMINGTON AIR PARK
KIMM	IMMOKALEE REGIONAL ARPT
KIMT	FORD ARPT
KIND	INDIANAPOLIS INTL ARPT
KINF	INVERNESS ARPT -FL
KINL	FALLS INTL ARPT
KINT	SMITH REYOLDS ARPT
KIPL	IMPERIAL COUNTY ARPT
KIPT	WILLIAMSPORT REGIONAL ARPT
KIRK	KIRKSVILLE REGIONAL
KIRS	KIRSCH MUNICIPAL ARPT
KISM	KISSIMMEE GATEWAY ARPT
KISN	SLOULIN FLD INTL ARPT
KISO	KINSTON REGIONAL JETPORT AT STALLINGS FIELD
KISP	LONG ISLAND MAC ARTHUR
KISW	ALEXANDER FIELD SOUTH WOOD COUNTY ARPT
KISZ	CINCINNATI-BLUE ASH ARPT
KITH	ITHICA TOMPKINS REGIONAL ARPT
KITR	KIT CARSON COUNTY
KIWA	PHOENIX-MESA GATEWAY
KIWD	GOGEBIC-IRON COUNTY ARPT
KIWH	WABASH MUNICIPAL ARPT
KIWS	WEST HOUSTON ARPT
KIXD	NEW CENTURY AIRCENTER ARPT
KIZG	EASTERN SLOPES REGIONAL ARPT
KJAC	JACKSON HOLE
KJAN	JACKSON EVERS INTL
KJAS	JASPER COUNTY ARPT-BELL FIELD
KJAX	JACKSONVILLE INTL
KJBR	JONESBORO MUNICIPAL ARPT
KJEF	JEFFERSON CITY MEMORIAL ARPT
KJFK	JOHN F KENNEDY INTL
KJGG	WILLIAMSBURG-JAMESTOWN ARPT
KJHW	CHAUTAUQUA COUNTY/JAMESTOWN ARPT
KJKA	JACK EDWARDS ARPT
KJLN	JOPLIN REGIONAL
KJMS	JAMESTOWN REGIONAL
KJNX	JOHNSTON COUNTY ARPT
KJQF	CONCORD REGIONAL ARPT
KJRB	DOWNTOWN MANHATTAN/WALL ST HELIP
KJSO	CHEROKEE COUNTY ARPT
KJST	JOHN MURTHA JOHNSTOWN-CAMBRIA COUNTY ARPT
KJSY	JOSEPH STATE
KJVL	SOUTHERN WISCONSIN REGIONAL ARPT
KJVY	CLARK COUNTY REGIONAL ARPT -IN
KJWN	JOHN C TUNE ARPT
KJXI	FOX STEPHENS FIELD-GILMER MUNI ARPT
KJXN	JACKSON COUNTY ARPT-REYNOLDS FIELD
KJYO	LEESBURG EXECUTIVE ARPT
KJZI	CHARLESTON EXECUTIVE ARPT
KJZP	PICKENS COUNTY ARPT -GA
KKLS	SOUTHWEST WASHINGTON REGIONAL ARPT
KLAA	LAMAR MUNICIPAL ARPT
KLAF	PURDUE UNIV ARPT
KLAL	LAKELAND LINDER REGIONAL
KLAN	CAPITAL REGION INTL ARPT
KLAR	LARAMIE REGIONAL
KLAS	MC CARRAN INTL ARPT
KLAW	LAWTON-FORT SILL REGIONAL ARPT
KLAX	LOS ANGELES INTL
KLBB	LUBBOCK PRESTON SMITH INTL ARPT
KLBE	ARNOLD PALMER REGIONAL
KLBF	NORTH PLATTE REGNL ARPT LEE BIRD FIELD
KLBL	LIBERAL MID-AMERICA REGNL ARPT
KLBO	FLOYD W. JONES LEBANON ARPT
KLBX	TEXAS GULF COAST REGIONAL ARPT
KLCG	WAYNE MUNI ARPT/STAN MORRIS FIELD
KLCH	LAKE CHARLES REGIONAL
KLCI	LACONIA MUNICIPAL
KLCK	RICKENBACKER INTL
KLCQ	LAKE CITY MUNICIPAL ARPT
KLDJ	LINDEN AIRPORT
KLDM	MASON COUNTY ARPT -MI
KLEB	LEBANON MUNICIPAL ARPT -NH
KLEE	LEESBURG INTL ARPT
KLEW	AUBURN-LEWISTON MUNICIPAL
KLEX	BLUE GRASS ARPT
KLFI	LANGLEY AIR FORCE BASE
KLFK	ANGELINA COUNTY
KLFT	LAFAYETTE REGIONAL
KLGA	LA GUARDIA ARPT
KLGB	LONG BEACH-DAUGH FLD
KLGC	LAGRANGE-CALLAWAY ARPT
KLGD	LA GRANDE/UNION COUNTY ARPT
KLGU	LOGAN-CACHE ARPT
KLHM	LINCOLN REGNL ARPT/KARL HARDER FLD
KLHX	LA JUNTA MUNICIPAL ARPT
KLIT	BILL AND  HILLARY CLINTON NATL ARPT/ADAMS FIELD
KLKR	LANCASTER COUNTY-MC WHIRTER FLD ARPT
KLKU	LOUISA COUNTY ARPT/FREEMAN FLD
KLLQ	MONTICELO MUNICIPAL ARPT/ELLIS FIELD
KLLR	LITTLE RIVER ARPT
KLMO	VANCE BRAND ARPT
KLMT	KLAMATH FALLS INTL
KLNA	PALM BEACH COUNTY PARK ARPT
KLNC	LANCASTER REGIONAL ARPT
KLNK	LINCOLN ARPT
KLNL	KINGS LAND O LAKES ARPT
KLNN	WILLOUGHBY LOST NATION MUNI ARPT
KLNS	LANCASTER ARPT -PA
KLOM	WINGS FIELD ARPT
KLOT	LEWIS UNIVERSITY ARPT
KLOU	BOWMAN FIELD
KLOZ	LONDON-CORBIN ARPT-MAGEE  FIELD
KLPR	LORAIN COUNTY REGIONAL ARPT
KLQK	PICKENS COUNTY ARPT -SC
KLRD	LAREDO INTL
KLRO	MT PLEASANT REGL ARPT-FAISON FIELD
KLRU	LAS CRUCES INTL
KLRY	LAWRENCE SMITH MEMORIAL ARPT
KLSE	LA CROSSE MUNICIPAL AIRPORT
KLUG	ELLINGTON AIRPORT
KLUK	CINCINNATI MUNI ARPT-LUNKEN FIELD
KLUL	HESLER-NOBLE FIELD ARPT
KLVJ	PEARLAND REGIONAL ARPT
KLVK	LIVERMORE MUNICIPAL ARPT
KLVN	AIRLAKE ARPT
KLWB	GREENBRIER VALLEY ARPT
KLWC	LAWRENCE MUNICIPAL  ARPT -KS
KLWD	LAMONI MUNICIPAL ARPT
KLWM	LAWRENCE MUNICIPAL ARPT -MA
KLWS	LEWISTON-NEZ PERCE CO ARPT
KLXT	LEES SUMMIT MUNICIPAL ARPT
KLYH	LYNCHBURG REGNL ARPT/PRESTON GLENN FIELD
KLZU	GWINNETT COUNTY - BRISCOE FIELD
KMAC	MACON DOWNTOWN ARPT
KMAF	MIDLAND INTL
KMAI	MARIANNA MUNICIPAL ARPT
KMBL	MANISTEE COUNTY-BLACKER ARPT
KMBO	BRUCE CAMPBELL FIELD
KMBS	MBS INTL
KMBT	MURFREESBORO MUNICIPAL ARPT
KMCB	MC COMB -PIKE COUNTY ARPT
KMCC	MC CLELLAN AIRFIELD
KMCD	MACKINAC ISLAND ARPT
KMCE	MERCED MUNICIPAL
KMCF	MACDILL AIR FORCE BASE
KMCI	KANSAS CITY INTL
KMCK	MC COOK BEN NELSON REGNL ARPT
KMCN	MIDDLE GEORGIA REGIONAL
KMCO	ORLANDO INTL
KMCW	MASON CITY MUNICIPAL
KMCX	WHITE COUNTY ARPT
KMDD	MIDLAND AIRPARK
KMDH	SOUTHERN ILLINOIS
KMDQ	MADISON COUNTY EXECUTIVE ARPT/TOM SHARP JR FIELD
KMDT	HARRISBURG INTL
KMDW	CHICAGO MIDWAY INTL ARPT
KMEI	KEY FLD
KMEM	MEMPHIS INTL
KMER	CASTLE ARPT
KMEZ	MENA INTERMOUNTAIN MUNICIPAL ARPT
KMFD	MANSFIELD LAHM MUNICIPAL
KMFE	MC ALLEN MILLER INTL
KMFI	MARSHFIELD MUNICIPAL ARPT
KMFR	ROGUE VALLEY INTL - MEDFORD ARPT
KMGC	MICHIGAN CITY MUNICIPAL ARPT
KMGE	DOBBINS AIR RESERVE BASE
KMGJ	ORANGE COUNTY ARPT -NY
KMGM	MONTGOMERY REGIONAL ARPT
KMGN	HARBOR SPRINGS ARPT
KMGW	MORGANTOWN MUNICIPAL ARPT-WALTER L. BILL HART FIELD
KMGY	DAYTON-WRIGHT BROTHERS ARPT
KMHE	MITCHELL MUNICIPAL ARPT
KMHK	MANHATTAN REGIONAL
KMHR	SACRAMENTO MATHER ARPT
KMHT	MANCHESTER AIRPORT
KMHV	MOJAVE ARPT
KMIA	MIAMI INTL
KMIC	CRYSTAL ARPT
KMIE	DELAWARE COUNTY REGIONAL ARPT
KMIV	MILLVILLE MUNICIPAL ARPT
KMJX	ROBT J MILLER AIR PARK
KMKC	CHARLES B WHEELER DOWNTOWN ARPT
KMKE	GENERAL MITCHELL INTL
KMKG	MUSKEGON COUNTY ARPT
KMKL	MC KELLER -SIPES REGIONAL ARPT
KMKT	MANKATO REGIONAL ARPT
KMKY	MARCO ISLAND ARPT
KMLB	MELBOURNE INTL
KMLC	MC ALESTER REGIONAL ARPT
KMLE	MILLARD ARPT
KMLI	QUAD CITY ARPT
KMLJ	BALDWIN COUNTY ARPT
KMLS	FRANK WILEY FIELD ARPT
KMLU	MONROE REGIONAL ARPT
KMMI	MCMINN COUNTY ARPT
KMMK	MERIDEN MARKHAM MUNICIPAL ARPT
KMML	SOUTHWEST MINNESOTA REGNL ARPT-MARSHALL/RYAN FIELD
KMMU	MORRISTOWN MUNICIPAL ARPT
KMMV	MC MINNVILLE MUNICIPAL ARPT
KMNM	MENOMINEE-MARINETTE TWIN CO ARPT
KMOB	MOBILE REGIONAL
KMOD	MODESTO CITY-COUNTY ARPT-HARRY SHAM FIELD
KMOP	MT PLEASANT MUNICIPAL ARPT
KMOT	MINOT INTL AIRPORT
KMPV	EDWARD F KNAPP STATE ARPT
KMQB	MACOMB MUNICIPAL ARPT
KMQI	DARE COUNTY REGIONAL ARPT
KMQJ	INDIANAPOLIS REGIONAL ARPT
KMQS	CHESTER COUNTY G O CARLSON ARPT
KMQT	MARQUETTE COUNTY
KMQY	SMYRNA ARPT
KMRB	EASTERN WEST VIRGINIA REGIONAL ARPT
KMRC	MAURY COUNTY ARPT
KMRH	MICHAEL J SMITH FIELD ARPT
KMRY	MONTEREY PENINSULA
KMSL	NORTHWEST ALABAMA REGIONAL ARPT
KMSN	DANE COUNTY REGIONAL ARPT-TRUAX FLD
KMSO	MISSOULA INTL ARPT
KMSP	MINNEAPOLIS-ST PAUL INTL/WOLD-CHAMBERLAIN ARPT
KMSS	MASSENA INTL ARPT-RICHARDS FIELD
KMSV	SULLIVAN COUNTY INTL
KMSY	LOUIE ARMSTRONG NEW ORLEANS INTL ARPT
KMTC	SELFRIDGE AIR NATIONAL GUARD BASE
KMTH	THE FLORIDA KEYS MARATHON
KMTJ	MONTROSE REGIONAL ARPT
KMTN	MARTIN STATE ARPT
KMTO	COLES COUNTY MEMORIAL ARPT
KMTP	MONTAUK ARPT
KMTV	BLUE RIDGE ARPT
KMTW	MANITOWOC COUNTY ARPT
KMUI	MUIR ARMY AIRFIELD
KMVY	MARTHAS VINEYARD
KMWA	WILLIAMSON COUNTY REGIONAL
KMWC	LAWRENCE J TIMMERMAN ARPT
KMWH	GRANT COUNTY ARPT
KMWK	MOUNT AIRY/SURRY COUNTY ARPT
KMWL	MINERAL WELLS ARPT
KMYF	MONTGOMERY FIELD ARPT
KMYL	MC CALL MUNICIPAL ARPT
KMYR	MYRTLE BEACH INTL
KMYV	YUBA COUNTY ARPT
KMZJ	PINAL AIRPARK
KNEW	LAKEFRONT AIRPORT
KNFW	NAS JRB FORT WORTH
KNGP	CORPUS CHRISTI NAS/TRUAX FIELD
KNGU	NORFOLK NAVAL STATION
KNHK	PATUXENT RIVER NAS
KNIP	JACKSONVILLE NAS -TOWERS FIELD
KNKT	CHERRY POINT MARINE AIR CORPS AIR ST
KNQA	MILLINGTON REGIONAL JETPORT ARPT
KNTU	OCEANA NAVAL AIR STATION
KNUC	SAN CLEMENTE ISLAND NALF
KNUQ	MOFFETT FEDERAL AIRFIELD
KNVD	NEVADA MUNICIPAL ARPT
KNYG	QUANTICO MCAF/TURNER FIELD
KNYL	YUMA MCAS/YUMA INTL ARPT
KNZY	NORTH ISLAND NAS -HALSEY FIELD
KOAJ	ALBERT J ELLIS
KOAK	METRO OAKLAND INTL
KOAR	MARINA MUNICIPAL ARPT
KOBE	OKEECHOBEE COUNTY ARPT
KOBI	WOODBINE MUNICIPAL ARPT
KOCF	OCALA INTL ARPT-JIM TAYLOR FIELD
KOCW	WARREN FIELD ARPT
KODO	ODESSA-SCHLEMEYER FIELD ARPT
KOEO	L O SIMENSTAD MUNICIPAL ARPT
KOFK	NORFOLK REGNL ARPT/KARL STEFAN MEMORIAL FIELD
KOFP	HANOVER COUNTY MUNICIPAL ARPT
KOGD	OGDEN-HINCKLEY ARPT
KOGS	OGDENSBURG INTL ARPT
KOIC	LT WARREN EATON ARPT
KOJC	JOHNSON COUNTY EXECUTIVE ARPT
KOKB	OCEANSIDE  MUNICIPAL ARPT
KOKC	WILL ROGERS WORLD ARPT
KOKH	WES LUPIEN
KOKK	KOKOMO MUNICIPAL ARPT
KOKM	OKMULGEE REGIONAL  ARPT
KOKV	WINCHESTER REGIONAL ARPT
KOLF	L M CLAYTON
KOLM	OLYMPIA ARPT
KOLS	NOGALES INTL ARPT
KOLU	COLUMBUS MUNICIPAL ARPT -NE
KOLV	OLIVE BRANCH ARPT
KOMA	EPPLEY AIRFIELD
KOMH	ORANGE COUNTY ARPT -VA
KOMK	OMAK ARPT
KOMN	ORMOND BEACH MUNICIPAL ARPT
KONA	WINONA MUNI ARPT-MAX CONRAD FIELD
KONO	ONTARIO MUNICIPAL ARPT
KONP	NEWPORT MUNICIPAL ARPT -OR
KONT	ONTARIO INTL ARPT
KONZ	GROSSE ILE MUNICIPAL ARPT
KOPF	OPA-LOCKA EXECUTIVE ARPT
KOPL	ST LANDRY PARISH ARPT-AHART FIELD
KOPN	THOMASTON-UPSON COUNTY ARPT
KOQN	BRANDYWINE ARPT
KOQU	QUONSET STATE ARPT
KORB	ORR REGIONAL ARPT
KORD	CHICAGO OHARE INTL ARPT
KORF	NORFOLK INTL
KORG	ORANGE COUNTY ARPT -TX
KORH	WORCESTER REGIONAL
KORK	NORTH LITTLE ROCK MUNICIPAL ARPT
KORL	EXECUTIVE ARPT
KORS	ORCAS ISLAND ARPT
KOSH	WITTMAN REGIONAL ARPT
KOSU	OHIO STATE UNIVERSITY
KOTG	WORTHINGTON MUNICIPAL ARPT
KOTH	SOUTHWEST OREGON REGIONAL ARPT
KOTM	OTTUMWA REGIONAL ARPT
KOUN	UNIV OF OKLAHOMA WESTHEIMER ARPT
KOWA	OWATONNA DEGNER REGIONAL ARPT
KOWB	OWENSBORO-DAVIESS
KOWD	NORWOOD MEMORIAL ARPT
KOXB	OCEAN CITY MUNICIPAL  ARPT -MD
KOXC	WATERBURY-OXFORD ARPT
KOXD	MIAMI UNIVERSITY ARPT
KOXR	OXNARD ARPT
KOXV	KNOXVILLE MUNICIPAL ARPT
KOZS	CAMDENTON MEMORIAL ARPT
KOZW	LIVINGSTON COUNTY SPENCER J HARDY
KPAE	SNOHOMISH CO -PAINE FIELD
KPAH	BARKLEY REGIONAL ARPT
KPAN	PAYSON ARPT
KPAO	PALO ALTO ARPT OF SANTA CLARA COUNTY
KPBG	PLATTSBURGH INTL ARPT
KPBH	PRICE COUNTY ARPT
KPBI	PALM BEACH INTL
KPBX	PIKE COUNTY ARPT - HATCHER FIELD
KPCM	PLANT CITY ARPT
KPCW	ERIE-OTTAWA INTL ARPT - CARL KELLER FIELD
KPCZ	WAUPACA MUNICIPAL ARPT
KPDK	DEKALB-PEACHTREE ARPT
KPDT	EASTERN OREGON REGNL ARPT AT PENDLETON
KPDX	PORTLAND INTL -OR
KPFN	PANAMA CITY - BAY COUNTY INTL
KPGA	PAGE MUNICIPAL
KPGD	PUNTA GORDA ARPT
KPGV	PITT-GREENVILLE ARPT
KPHF	NEWPORT NEWS/WILLIAMSBURG INTL
KPHL	PHILADELPHIA INTL
KPHN	ST CLAIR COUNTY INTL ARPT
KPHX	PHOENIX SKY HARBOR INTL ARPT
KPIA	GENERAL DOWNING-PEORIA INTL ARPT
KPIB	HATTIESBURG-LAUREL
KPIE	ST. PETE-CLEARWATER INTL ARPT
KPIH	POCATELLO REGIONAL ARPT
KPIR	PIERRE REGIONAL ARPT
KPIT	PITTSBURGH INTL ARPT
KPJC	ZELIENOPLE MUNICIPAL
KPJY	PINCKNEYVILLE-DU QUOIN
KPKB	MID-OHIO VALLEY REGIONAL
KPLB	CLINTON COUNTY ARPT
KPLK	M GRAHAM CLARK - TANEY COUNTY ARPT
KPLN	PELLSTON REGNL ARPT OF EMMET COUNTY
KPLU	PIERCE CO - THUN FIELD ARPT
KPMD	PALMDALE USAF PLANT 42 ARPT
KPMH	GREATER PORTSMOUTH REGIONAL ARPT
KPMP	POMPANO BEACH AIRPARK
KPMU	PANOLA COUNTY ARPT
KPNC	PONCA CITY MUNICIPAL ARPT
KPNE	NORTHEAST PHILADELPHIA ARPT
KPNM	PRINCETON MUNICIPAL
KPNS	PENSACOLA INTL ARPT
KPOC	BRACKETT FIELD ARPT
KPOF	POPLAR BLUFF MUNICIPAL
KPOU	DUTCHESS COUNTY ARPT
KPOV	PORTAGE COUNTY ARPT
KPPF	TRI-CITY ARPT -PARSONS
KPPQ	PITTSFIELD PENSTONE MUNICIPAL ARPT
KPQI	NORTHERN MAINE REGIONAL
KPRB	PASO ROBLES MUNICIPAL ARPT
KPRC	ERNEST A LOVE FIELD
KPSC	TRI-CITIES
KPSF	PITTSFIELD MUNICIPAL ARPT -MA
KPSM	PORTSMOUTH INTL ARPT AT PEASE
KPSN	PALESTINE MUNICIPAL ARPT
KPSP	PALM SPRINGS INTL
KPTD	POTSDAM MUNICIPAL ARPT -DAMON FIELD
KPTK	OAKLAND COUNTY INTL
KPTN	HARRY P WILLIAMS MEMORIAL ARPT
KPTS	ATKINSON MUNICIPAL
KPTV	PORTERVILLE MUNICIPAL ARPT
KPUB	PUEBLO MEMORIAL ARPT
KPUJ	PAULDING NORTHWEST ATLANTA ARPT
KPUW	PULLMAN/MOSCOW REGIONAL ARPT
KPVC	PROVINCETOWN MUNICIPAL ARPT
KPVD	THEODORE FRANCIS GREEN STATE
KPVG	HAMPTON ROADS EXECUTIVE
KPVU	PROVO MUNICIPAL ARPT
KPWA	WILEY POST ARPT
KPWC	PINE RIVER REGIONAL ARPT
KPWK	CHICAGO EXECUTIVE ARPT
KPWM	PORTLAND INTL JETPORT -ME
KPWT	BREMERTON NATIONAL ARPT
KPYM	PLYMOUTH MUNICIPAL ARPT -MA
KRAC	JOHN H BATTEN ARPT
KRAL	RIVERSIDE MUNICIPAL ARPT
KRAP	RAPID CITY REGIONAL
KRBD	DALLAS EXECUTIVE ARPT
KRBL	RED BLUFF MUNICIPAL ARPT
KRCM	SKYHAVEN
KRCR	FULTON COUNTY ARPT -IN
KRDD	REDDING MUNICIPAL
KRDG	READING REGNL ARPT/CARL A SPAATZ FIELD
KRDM	ROBERTS FIELD ARPT
KRDU	RALEIGH-DURHAM INTL
KRED	RED LODGE ARPT
KRFD	CHICAGO/ROCKFORD INTL ARPT
KRFG	ROOKE FIELD ARPT
KRFI	RUSK COUNTY ARPT
KRHI	RHINELANDER-ONEIDA COUNTY
KRHV	REID-HILLVIEW ARPT OF SANTA CLARA CNTY
KRIC	RICHMOND INTL
KRIL	GARFIELD COUNTY REGIONAL ARPT
KRIV	MARCH ARB ARPT
KRIW	RIVERTON REGIONAL
KRKD	KNOX COUNTY REGIONAL
KRKP	ARANSAS COUNTY ARPT
KRKS	ROCK SPRINGS-SWEETWATER CO
KRLD	RICHLAND ARPT
KRME	GRIFFISS INTL
KRMG	RICHARD B RUSSELL
KRMN	STAFFORD REGIONAL ARPT
KRMY	BROOKS FIELD ARPT -MI
KRNH	NEW RICHMOND REGIONAL
KRNM	RAMONA ARPT
KRNO	RENO TAHOE INTL
KRNP	OWOSSO COMMUNITY ARPT
KRNT	RENTON MUNICIPAL ARPT
KRNV	CLEVELAND MUNICIPAL ARPT
KROA	ROANOKE REGNL ARPT/WOODRUM FIELD
KROC	GREATER ROCHESTER INTL
KROG	ROGERS MUNICIPAL ARPT-CARTER FIELD
KROS	RUSH CITY REGIONAL ARPT
KROW	ROSWELL INTL AIR CENTER
KROX	ROSEAU MUNI ARPT/RUDY BILLBERG FLD
KRPB	BELLEVILLE MUNICIPAL
KRPD	RICE LAKE REGIONAL ARPT CARLS FIELD
KRPH	GRAHAM MUNICIPAL ARPT
KRQB	ROBEN-HOOD ARPT
KRQO	EL RENO REGIONAL ARPT
KRRL	MERRILL MUNICIPAL ARPT
KRRQ	ROCK RAPIDS MUNICIPAL ARPT
KRRT	WARROAD INTL MEMORIAL ARPT
KRSN	RUSTON REGIONAL ARPT
KRST	ROCHESTER INTL
KRSW	SOUTHWEST FLORIDA INTL ARPT
KRUE	RUSSELLVILLE REGIONAL ARPT
KRUQ	ROWAN COUNTY ARPT
KRUT	RUTLAND-SOUTHERN VERMONT REGNL ARPT
KRVS	RICHARD LLOYD JONES JR ARPT
KRWF	REDWOOD FALLS MUNICIPAL ARPT
KRWI	ROCKY MOUNT-WILSON REGNL ARPT
KRYN	RYAN FIELD ARPT
KRYV	WATERTOWN MUNICIPAL ARPT
KRYW	LAGO VISTA TX - RUSTY ALLEN ARPT
KRYY	COBB COUNTY ARPT-MC COLLUM FIELD
KRZL	JASPER COUNTY ARPT
KSAC	SACRAMENTO EXECUTIVE ARPT
KSAF	SANTA FE MUNICIPAL
KSAN	SAN DIEGO INTL
KSAT	SAN ANTONIO INTL
KSAV	SAVANNAH/HILTON HEAD INTL ARPT
KSAW	SAWYER INTL
KSBA	SANTA BARBARA MUNICIPAL
KSBD	SAN BERNARDINO INTL ARPT
KSBM	SHEBOYGAN COUNTY MEMORIAL ARPT
KSBN	SOUTH BEND REGIONAL
KSBP	SAN LUIS COUNTY REGIONAL ARPT
KSBS	STEAMBOAT SPRINGS ARPT/BOB ADAMS FIELD
KSBY	SALISBURY-OCEAN CITY WICOMICO REGNL ARPT
KSCH	SCHENECTADY COUNTY
KSCK	STOCKTON METRO
KSDF	LOUISVILLE INTL ARPT-STANDIFORD FIELD
KSDL	SCOTTSDALE ARPT
KSDM	BROWN FIELD MUNICIPAL ARPT
KSDY	SIDNEY-RICHLAND MUNICIPAL ARPT
KSEA	SEATTLE-TACOMA INTL
KSEE	GILLESPIE FIELD ARPT
KSEF	SEBRING REGIONAL ARPT
KSEP	CLARK FIELD MUNICIPAL ARPT
KSER	FREEMAN MUNICIPAL ARPT
KSEZ	SEDONA ARPT
KSFB	ORLANDO SANFORD INTL ARPT
KSFF	FELTS FIELD ARPT
KSFM	SANFORD REGIONAL ARPT
KSFO	SAN FRANCISCO INTL ARPT
KSFQ	SUFFOLK EXECUTIVE ARPT
KSFZ	NORTH CENTRAL STATE ARPT
KSGF	SPRINGFIELD-BRANSON NATIONAL
KSGH	SPRINGFIELD-BECKLEY MUNICIPAL ARPT
KSGJ	ST AUGUSTINE
KSGR	SUGAR LAND REGIONAL ARPT
KSGS	SOUTH ST PAUL MUNI ARPT-RICHARD E FLEMING FIELD
KSGT	STUTTGART MUNICIPAL ARPT
KSGU	ST GEORGE MUNICIPAL ARPT
KSHD	SHENANDOAH VALLEY
KSHR	SHERIDAN COUNTY ARPT
KSHV	SHREVEPORT REGIONAL
KSIF	ROCKINGHAM COUNTY NC SHILOH ARPT
KSIK	SIKESTON MEMORIAL MUNICIPAL ARPT
KSJC	NORMAN Y. MINETA SAN JOSE INTL ARPT
KSJT	SAN ANGELO REGNL ARPT/MATHIS FIELD
KSJX	BEAVER ISLAND ARPT
KSKY	GRIFFING SANDUSKY ARPT
KSLC	SALT LAKE CITY INTL
KSLE	MCNARY FLD ARPT
KSLI	LOS ALAMITOS ARMY AIRFIELD
KSLK	ADIRONDAK REGIONAL ARPT
KSLN	SALINA MUNICIPAL
KSMD	SMITH FIELD ARPT
KSMF	SACRAMENTO INTL
KSMO	SANTA MONICA MUNICIPAL
KSMS	SUMTER ARPT
KSMX	SANTA MARIA PUBLIC ARPT/CAPT G ALLAN HANCOCK FIELD
KSNA	JOHN WAYNE-ORANGE COUNTY ARPT
KSNC	CHESTER ARPT
KSNK	WINSTON FIELD ARPT
KSNS	SALINAS MUNICIPAL ARPT
KSNY	SIDNEY MUNI ARPT/LLOYD W. CARR FIELD
KSOA	SONORA MUNICIPAL ARPT
KSOP	MOORE COUNTY ARPT
KSOW	SHOW LOW REGIONAL ARPT
KSPA	SPARTANBURG DOWNTOWN MEMORIAL ARPT
KSPG	ALBERT WHITTED
KSPI	ABRAHAM LINCOLN CAPITAL ARPT
KSPK	SPANISH FORK-SPRINGVILLE
KSPS	SHEPPARD AFB/WICHITA FALLS MUNI ARPT
KSPW	SPENCER MUNICIPAL AIRPORT
KSPX	HOUSTON GULF ARPT
KSQL	SAN CARLOS ARPT
KSRB	UPPER CUMBERLAND REGIONAL ARPT
KSRC	SEARCY MUNICIPAL ARPT
KSRE	SEMINOLE MUNICIPAL ARPT
KSRQ	SARASOTA-BRADENTON INTL ARPT
KSRR	SIERRA BLANCA REGIONAL
KSSF	STINSON MUNICIPAL ARPT
KSSI	MALCOLM MCKINNON ARPT
KSSQ	SHELL LAKE MUNICIPAL ARPT
KSTC	ST. CLOUD REGIONAL
KSTF	GEORGE M BRYAN ARPT
KSTJ	ROSECRANS MEMORIAL ARPT
KSTL	LAMBERT-ST LOUIS INTL
KSTP	ST. PAUL DOWNTOWN ARPT/HOLMAN FIELD
KSTS	CHARLES M. SCHULZ-SONOMA COUNTY ARPT
KSUA	WITHAM FIELD ARPT
KSUN	FRIEDMAN MEMORIAL
KSUS	SPIRIT OF ST LOUIS
KSUT	CAPT FEAR REGNL JETPORT/HOWIE FRANKLIN FIELD ARPT
KSUU	TRAVIS AIR FORCE BASE
KSUW	RICHARD I BONG ARPT
KSUX	SIOUX GATEWAY ARPT/COL. BUD DAY FIELD
KSVC	GRANT COUNTY
KSVE	SUSANVILLE MUNICIPAL ARPT
KSWF	STEWART INTL AIRPORT
KSWO	STILLWATER REGIONAL ARPT
KSXL	SUMMERSVILLE ARPT
KSXU	SANTA ROSA ROUTE 66
KSYR	SYRACUSE HANCOCK INTL
KSZT	SANDPOINT ARPT
KSZY	ROBERT SIBLEY ARPT
KTAN	TAUNTON MUNICIPAL ARPT - KING FIELD
KTBN	WAYNESVILLE-ST ROBERT REGIONAL FORNEY FIELD
KTBR	STATESBORO -BULLOCH COUNTY ARPT
KTCC	TUCUMCARI MUNICIPAL ARPT
KTCL	TUSCALOOSA REGIONAL ARPT
KTCM	MCCORD FIELD ARPT
KTCY	TRACY MUNICIPAL ARPT
KTDF	PERSON COUNTY ARPT
KTDW	TRADEWIND ARPT
KTDZ	TOLEDO EXECUTIVE ARPT
KTEB	TETERBORO AIRPORT
KTEL	PERRY COUNTY MUNICIPAL
KTEX	TELLURIDE REGIONAL ARPT
KTGI	TANGIER ISLAND ARPT
KTHV	YORK ARPT
KTIW	TACOMA NARROWS ARPT
KTIX	SPACE COAST REGIONAL
KTKI	MCKINNEY NATIONAL ARPT
KTKV	TOMAHAWK REGIONAL ARPT
KTLH	TALLAHASSEE REGIONAL
KTLR	MEFFORD FIELD ARPT
KTMB	KENDALL-TAMIAMI EXECUTIVE ARPT
KTME	HOUSTON EXECUTIVE ARPT
KTNT	DADE-COLLIER TRAINING AND TRANSITION ARPT
KTOA	ZAMPERINI FIELD ARPT
KTOI	TROY MUNICIPAL ARPT
KTOL	TOLEDO EXPRESS ARPT
KTOP	PHILIP BILLARD MUNICIPAL ARPT
KTPA	TAMPA INTL
KTPF	PETER O KNIGHT ARPT
KTQK	SCOTT CITY MUNICIPAL ARPT
KTRI	TRI-CITIES REGIONAL TN/VA ARPT
KTRK	TRUKEE-TAHOE ARPT
KTRM	JACQUELINE COCHRAN REGIONAL ARPT
KTRX	TRENTON MUNICIPAL ARPT
KTSO	CARROLL COUNTY-TOLSON ARPT
KTSP	TEHACHAPI MUNICIPAL ARPT
KTTA	RALEIGH EXEC JETPORT AT SANFORD-LEE CNTY ARPT
KTTD	PORTLAND-TROUTDALE ARPT
KTTF	CUSTER ARPT
KTTN	TRENTON MERCER ARPT
KTTS	NASA SHUTTLE LANDING FACILITY
KTUL	TULSA INTL
KTUP	TUPELO REGIONAL ARPT
KTUS	TUCSON INTL
KTVC	CHERRY CAPITAL ARPT
KTVF	THIEF RIVER FALLS REGIONAL
KTVL	LAKE TAHOE ARPT
KTVR	VICKSBURG TALLULAH REGIONAL ARPT
KTVY	BOLINDER FIELD - TOOELE VALLEY ARPT
KTWF	JOSLIN FIELD - MAGIC VALLEY REGIONAL
KTXK	TEXARKANA-WEBB FIELD
KTYQ	INDIANAPOLIS EXECUTIVE ARPT
KTYR	TYLER POUNDS REGIONAL ARPT
KTYS	MC GHEE TYSON ARPT
KTZR	BOLTON FIELD ARPT
KUBX	CUBA MUNICIPAL ARPT
KUCA	ONEIDA COUNTY ARPT
KUCP	NEW CASTLE MUNICIPAL ARPT
KUCY	EVERETT-STEWART REGIONAL ARPT
KUDD	BERMUDA DUNES ARPT
KUES	WAUKESHA COUNTY ARPT
KUGN	WAUKEGAN REGIONAL ARPT
KUIN	QUINCY REGIONAL ARPT - BALDWIN FLD
KUIZ	BERZ-MACOMB ARPT
KUKF	WILKES COUNTY AIRPORT
KUKI	UKIAH MUNICIPAL ARPT
KUMP	INDIANAPOLIS METROPOLITAN ARPT
KUNI	OHIO UNIVERSITY ARPT-SNYDER FIELD
KUNO	WEST PLAINS REGIONAL ARPT
KUNV	UNIVERSITY PARK ARPT
KUOS	FRANKLIN COUNTY ARPT
KUTA	TUNICA MUNICIPAL ARPT
KUUU	NEWPORT STATE ARPT
KUVA	GARNER FIELD ARPT
KUYF	MADISON COUNTY ARPT
KUZA	ROCK HILL -YORK CO BRYANT FLD
KVAD	MOODY AIR FORCE BASE
KVAY	SOUTH JERSEY REGIONAL ARPT
KVBG	VANDENBERG AIR FORCE BASE
KVCB	NUT TREE AIRPORT
KVCT	VICTORIA REGIONAL
KVCV	SOUTHERN CALIFORNIA LOGISTICS
KVDF	TAMPA EXECUTIVE ARPT
KVEL	VERNAL ARPT
KVER	JESSE VIERTEL MEMORIAL ARPT
KVGC	HAMILTON MUNICIPAL ARPT
KVGT	NORTH LAS VEGAS
KVIH	ROLLA NATIONAL ARPT
KVIS	VISALIA MUNICIPAL ARPT
KVJI	VIRGINIA HIGHLANDS ARPT
KVLD	VALDOSTA REGIONAL
KVLL	OAKLAND/TROY ARPT
KVMR	HAROLD DAVIDSON FIELD ARPT
KVNC	VENICE MUNICIPAL AIRPORT
KVNY	VAN NUYS ARPT
KVOK	VOLK FIELD ARPT
KVPS	EGLIN AIR FORCE BASE/DESTIN-FORT WALTON BEACH AIRPORT
KVPZ	PORTER COUNTY MUNICIPAL
KVQQ	CECIL ARPT
KVRB	VERO BEACH MUNICIPAL
KVSF	HARTNESS STATE ARPT -SPRINGFIELD
KVTA	NEWARK-HEATH ARPT
KVTN	MILLER FIELD ARPT
KVUJ	STANLY COUNTY ARPT
KVUO	PEARSON FIELD ARPT
KWAL	WALLOPS FLIGHT FACILITY
KWAY	GREEN COUNTY
KWDG	ENID WOODRING REGIONAL ARPT
KWDR	BARROW COUNTY ARPT
KWHP	WHITEMAN AIRPORT
KWJF	GENERAL WM J FOX AIRFIELD
KWLD	STROTHER FIELD ARPT
KWLW	WILLOWS-GLENN COUNTY ARPT
KWRI	MC GUIRE AIR FORCE BASE
KWRL	WORLAND MUNICIPAL ARPT
KWST	WESTERLY STATE ARPT
KWVI	WATSONVILLE MUNICIPAL ARPT
KWWD	CAPE MAY COUNTY ARPT
KWYS	YELLOWSTONE ARPT
KXLL	ALLENTOWN QUEEN CITY MUNICIPAL
KXNA	NW ARKANSAS REGIONAL
KXSA	TAPPAHANNOCK-ESSEX COUNTY
KYIP	WILLOW RUN ARPT
KYKM	YAKIMA AIR TERMINAL/MCALLISTER FIELD
KYKN	CHAN GURNEY MUNICIPAL ARPT
KYNG	YOUNGSTOWN-WARREN RGNL ARPT
KZER	SCHUYKILL COUNTY -JOE ZERBEY ARPT
KZPH	ZEPHYRHILLS MUNICIPAL ARPT
KZZV	ZANESVILLE MUNICIPAL ARPT
L26	HESPERIA ARPT
L35	BIG BEAR CITY
L66	POLLOCK MUNICIPAL
LA09	AIR LOGISTICS HELIPORT
LA28	LA STATE POLICE HELIPORT
LBBG	BURGAS ARPT
LEBL	BARCELONA ARPT
LEMD	MADRID-BARAJAS
LEMG	MALAGA ARPT
LERT	ROTA
LEVC	VALENCIA AIRPORT
LEZG	ZARAGOZA
LFCO	OLORON-HERRERE ARPT
LFMN	NICE COTE DAZUR INTL ARPT
LFPG	CHARLES DE GAULLE
LFPO	ORLY
LFSB	BASEL-MULHOUSE-FREIBURG
LGAV	ELEFTHERIOS VENIZELOS INTL
LGKM	KAVALA GREECE
LGTS	MAKEDONIA
LHBP	FERIHEGY ARPT
LICZ	SIGONELLA
LIMC	MILANO MALPENSA
LIPA	AVIANO AIR BASE
LIPH	TREVISO ARPT
LIPZ	MARCO POLO INTL
LIRA	CIAMPINO -ROME
LIRF	FIUMICINO ARPT
LIRN	CAPODICHINO -NAPLES
LIRP	GALILEO GALILEI ARPT
LL10	NAPER AERO CLUB ARPT
LLBG	BEN GURION ARPT
LOWW	VIENNA INTL
LPLA	LAJES AIRPORT
LPPT	LISBON INTL ARPT
LQTZ	TUZLA AIR BASE
LROP	HENRI COANDA INTL ARPT
LS08	ROBERT L SUGGS HELIPORT
LS99	PHI FOURCHON BASE HELIPORT
LSGG	GENEVA INTL ARPT
LSZH	ZURICH
LTAG	INCIRLIK AIR BASE
LTBA	ATAURK INTL
LTBJ	ADNAN MENDERES
M05	CARUTHERSVILLE MEMORIAL ARPT
M17	BOLIVAR MUNICIPAL ARPT
M19	NEWPORT MUNICIPAL ARPT -AK
M20	GRAYSON COUNTY ARPT
M22	BILL PUGH FIELD ARPT
M31	ARNOLD FIELD ARPT
M33	SUMNER COUNTY REGIONAL
M34	KENTUCKY DAM STATE PARK
M37	RULEVILLE-DREW ARPT
M48	HOUSTON MEMORIAL ARPT
M54	LEBANON MUNICIPAL ARPT -TN
M83	MCCHAREN FIELD
MA39	BRIGHAM AND WOMENS HOSPITAL HELIPORT
MBPV	PROVIDENCIALES INTL
MD24	HAYSFIELD ARPT
MD71	UNIV OF MD SHOCK TRAUMA CTR HELIPORT
MD99	MORAN FIELD ARPT
MDJB	LA ISABELA  INTL ARPT
MDLR	LA ROMANA INTL
MDPC	PUNTA CANA INTL
MDPP	PUERTO PLATA INTL
MDSD	SANTO DOMINGO/LAS AM
MDST	SANTIAGO CIBAO INTL
ME19	CLAYTON LAKE STRIP ARPT
ME79	TWO FALLS ARPT
MGGT	LA AURORA
MHLM	SAN PEDRO SULA LA MESA
MHTG	TONCONTIN INTL
MI32	UMMC HELIPORT
MKJP	NORMAN MANLEY INTL
MKJS	SANGSTER INTL
MMAA	GEN JUAN ALVAREZ INTL ARPT
MMAS	AQUASCALIENTES
MMCU	GENERAL ROBERTO FIERRO VILLALOBOS INTL
MMCZ	COZUMEL MEXICO
MMGL	GUADALAJARA, MEXICO
MMGM	GUAYMAS INTL
MMHO	GENERAL IGNACIO P GARCIA INTL
MMLM	LOS MOCHIS
MMLO	GUANAJUATO DEL BAJIO INTL
MMMG	MULEGE AIRSTRIP
MMMX	BENITO JUAREZ INTL
MMMY	GENERAL ESCOBEDO INTL
MMMZ	GENERAL RAFAEL BUELNA INTL
MMPB	PUEBLA MEXICO
MMPR	PUERTO VALLARTA
MMSD	LOS CABOS INTL
MMTO	TOLUCA/LIC ADOLFO
MMUN	CANCUN INTL
MMVR	GENERAL HERIBERTO JARA INTL ARPT
MMZH	IXTAPA-ZIHUATENEJO
MN56	CHARLTON BUILDING HELIPORT
MNMG	MANAGUA INTL ARPT
MO28	BLUE SPRINGS HELIPORT
MO3	STOCKTON MUNICIPAL ARPT
MO63	ST LUKES NORTHLAND HOSPITAL HELIPORT
MO91	BARNES JEWISH HOSPITAL
MPHO	PANAMA PACIFIC INTL ARPT
MPTO	TOCUMEN INTL
MRLB	DANIEL ODUBER QUIROS INTL
MROC	JUAN SANTAMARIA INTL
MSLP	EL SALVADOR INTL
MTPP	PORT-AU-PRINCE INTL
MU02	C.E.F. AIRPORT
MUHA	JOSE MARTI INTL ARPT
MWCR	OWEN ROBERTS INTL
MYAK	CONGO TOWN BAHAMAS
MYGF	FREEPORT INTL
MYNN	LYNDEN PINDLING INTL ARPT
MYSM	SAN SALVADOR INTL
MZBZ	BELIZE INTERNATIONAL ARPT
N03	CORLAND COUNTY ARPT-CHASE FIELD
N07	LINCOLN PARK ARPT
N14	FLYING W ARPT
N51	SOLBERG-HUNTERDON
N57	NEW GARDEN
N66	ONEONTA MUNICIPAL ARPT
N72	WARWICK MUNICIPAL ARPT
N81	HAMMONTON MUNICIPAL
N87	TRENTON-ROBBINSVILLE ARPT
NC14	BOONE INC ARPT
NC30	MILLER AIR PARK ARPT
NFFN	NADI INTL
NFNA	NAUSORI INTL ARPT
NSTU	PAGO PAGO INTL
NTAA	TAHITI FAAA
NV74	CALVADA MEADOWS ARPT
NY0	FULTON COUNTY ARPT
NY22	NYPD AIR OPS HELIPORT -PVT
NZAA	AUCKLAND INTL
O03	MORGANTOWN ARPT
O07	WESTHEIMER AIR PARK
O22	COLUMBIA ARPT
O41	WATTS-WOODLAND ARPT
O43	YERINGTON MUNICIPAL ARPT
O69	PETALUMA MUNICIPAL ARPT
O85	BENTON FIELD ARPT
O88	RIO VISTA MUNICIPAL ARPT
OAIX	BAGRAM AIR BASE
OBBI	BAHRAIN INTL
OEDR	DHAHRAN INTL
OEHL	HAIL
OERY	RIYAHD AIR BASE
OETN	RAS TANAJIB
OG30	AEROACRES ARPT
OI65	AULTMAN HOSPITAL HELIPORT
OMDB	DUBAI INTL
OPRN	ISLAMABAD -PAKISTAN
OR81	OLINGER AIRPARK
OTBD	DOHA INTL
P10	POLACCA ARPT
P19	STELLAR AIRPARK
P72	PENNS LANDING HELIPORT
PABE	BETHEL ARPT
PABG	BELUGA AIRPORT
PABR	WILEY POST-WILL ROGERS MEM
PACD	COLD BAY ARPT
PACK	CHEFORNAK ARPT
PACM	SCAMMON BAY AIRPORT
PACV	MERLE K -MUDHOLE SMITH ARPT
PADK	ADAK ARPT
PADL	DILLINGHAM ARPT
PADQ	KODIAK AIRPORT
PADU	UNALASKA ARPT
PADY	KONGIGANAK ARPT
PAED	ELMENDORF AIR FORCE BASE
PAEE	EEK ARPT
PAEM	EMMONAK ARPT
PAEN	KENAI MUNICIPAL ARPT
PAEW	NEWTOK ARPT
PAFA	FAIRBANKS INTL ARPT
PAGA	EDWARD G PITKA SR ARPT
PAGS	GUSTAVUS ARPT
PAHL	HUSLIA ARPT
PAHO	HOMER ARPT
PAJN	JUNEAU INTL ARPT
PAKD	KODIAK MUNICIPAL ARPT
PAKI	KIPNUK ARPT
PAKN	KING SALMON
PAKT	KETCHIKAN INTL ARPT
PAKU	UGNU-KUPARUK ARPT
PAKW	KLAWOCK ARPT
PAKY	KARLUK ARPT
PALH	LAKE HOOD -SPB
PAML	MANLEY HOT SPRINGS ARPT
PAMR	MERRILL FIELD ARPT
PANC	TED STEVENS ANCHORAGE INTL
PANI	ANIAK AIRPORT
PAOH	HOONAH ARPT
PAOM	NOME ARPT
PAOO	TOKSOOK BAY ARPT
PAOT	RALPH WIEN MEMORIAL ARPT
PAPB	ST. GEORGE  ARPT
PAPG	PETERSBURG JAMES A JOHNSON ARPT
PAPH	PORT HEIDEN AIRPORT
PAQT	NUIQSUT ARPT
PASC	DEADHORSE ARPT
PASD	SAND POINT ARPT
PASI	SITKA ROCKY GUTIERREZ ARPT
PASK	SELAWICK ARPT
PASO	SELDOVIA
PASV	SPARREVOHN LRRS ARPT
PASX	SOLDOTNA AIRPORT
PASY	EARECKSON AIR STATION
PATK	TALKEETNA ARPT
PAVD	VALDEZ PIONEER FIELD ARPT
PAWD	SEWARD ARPT
PAWG	WRANGELL ARPT
PAYA	YAKUTAT ARPT
PCUW	CUBE COVE
PFCL	CLARKS POINT ARPT
PFKA	KASIGLUK ARPT
PFNO	ROBERT -BOB CURTIS MEMORIAL ARPT
PGM	PORT GRAHAM ARPT
PGRO	ROTA INTL ARPT
PGSN	FRANCISCO C. ADA/SAIPAN INTL ARPT
PGUM	GUAM INTL ARPT
PGWT	TINIAN INTL
PHDH	DILLINGHAM AIRFIELD
PHHN	HANA ARPT
PHJH	KAPALUA ARPT
PHJR	KALAELOA ARPT JOHN RODGERS FIELD
PHKO	KONA INTL ARPT AT KEAHOLE
PHLI	LIHUE ARPT
PHLU	KALAUPAPA ARPT
PHMK	MOLOKAI ARPT
PHNL	HONOLULU INTL ARPT
PHNY	LANAI ARPT
PHOG	KAHULUI ARPT
PHTO	HILO INTL ARPT
PJON	JOHNSTON ATOLL ARPT
PKMJ	MARSHALL ISLANDS INTL ARPT
PKWA	BUCHOLZ AAF MARSHALL
PLPA	PALMYRA -COOPER AIRPORT
PMDY	HENDERSON FIELD
PTPN	POHNPEI INTL ARPT
PVT	PRIVATE AIR STRIP
PWAK	WAKE ISLAND AIRFIELD
R47	RUHES ARPT
RCKH	KAOHSIUNG INTL
RCTP	TAIBEI INTL
RIGG	OIL RIG
RJAA	NARITA INTL ARPT
RJBB	KANSAI INTL
RJCC	NEW CHITOSE
RJNA	NAGOYA JAPAN
RJOI	IWAKUNI
RJTQ	MIYAKEJIMA
RJTT	TOKYO INTL
RJTY	TACHIKAWA/YOKOTA AB ARPT
RKJK	KUNSAN
RKPK	PUSAN
RKSI	INCHEON INTL
RKSS	KIMPO INTL
RMPC	MACTAN CEBU ARPT
RPLB	SUBIC BAY INTL
RPLC	CLARK INTL
RPLL	MANILA-NINOY AQUINO INTL
RPVM	MACTAN-CEBU INTL
S03	ASHLAND MUNI ARPT- SUMNER PARKER FLD
S19	MCCORMICK COUNTY
S21	SUNRIVER
S31	LOPEZ ISLAND ARPT
S32	COOPERSTOWN MUNICIPAL ARPT
S43	HARVEY FIELD
S48	COUNTRY SQUIRE AIRPARK
S50	AUBURN MUNICIPAL ARPT -WA
S72	ST. MARIES MUNICIPAL
S83	SHOSHONE COUNTY ARPT
SABE	JORGE NEWBERY
SAEZ	MINISTRO PISTARINI
SBGL	GALEAO INTL -RIO
SBGR	GUARULHOS INTL
SBKP	VIRACOPOS-CAMPINAS INTL ARPT
SCEL	SANTIAGO INTL
SEGU	GUAYAQUIL/S BOLIVAR
SEMT	ELOY ALFARO INTL
SEQU	OLD MARISCAL SUCRE INTL ARPT
SGES	CIUDAD DEL ESTE GARCIA
SKBO	SANTA FE DE BOGOTA
SKBQ	ERNESTO CORTISSOZ
SKCL	CALI/VALLE
SKRG	JOSE MARIA CORDOVE ARPT
SKSP	GUSTAVO ROJAS PINILLA INTL ARPT
SLVR	VIRU VIRU INTL
SPANI	
SPIM	JORGE CHAVEZ INTL
SUMU	INTL DE CARRASCO
SVMC	LA CHINITA INTL
SVMI	SIMON BOLIVAR INTL
SVVA	ARTURO MICHELENA INTL
T05	CHARLES R JOHNSON ARPT
T40	MCGEHEE CATFISH REST
T67	HICKS AIRFIELD
T82	GILLESPIE COUNTY
TAPA	V C BIRD INTL ARPT
TBPB	GRANTLEY ADAMS BARBA
TDPD	DOUGLAS-CHARLES AIRPORT
TGPY	MAURICE BISHOP INTL ARPT
TIST	CYRIL E KING ARPT
TISX	HENRY E ROHLSEN ARPT
TJBQ	RAFAEL HERNANDEZ ARPT
TJMZ	EUGENIO MARIA DE HOSTOS ARPT
TJPS	MERCEDITA ARPT
TJSJ	LUIS MUNOZ MARIN INTL
TKPK	ROBT L BRADSHAW INTL
TLPC	ST. LUCIA-VIGIE
TLPL	HEWANORRA ST LUCIA
TN85	HOGUE ARPT
TNCA	ORANJESTAD/REINA BEA
TNCM	PRINCESS JULIANA
TQPF	WALLBLAKE
TRPG	OSBORNE ARPT
TTPP	PIARCO TRINIDAD
TUPJ	T B LETTSOME INTL
TX17	ETMC - ATHENS HELIPORT
TX33	HAIRE ARPT
TXKF	L F WADE INTL ARPT
TYE	TYONEK ARPT
U42	SOUTH VALLEY REGIONAL ARPT
U68	NORTH BIG HORN COUNTY ARPT
UAAA	ALMATY INTL ARPT
UCFM	MANAS INTL ARPT
UHHH	KHABAROVSK
UT25	MONUMENT VALLEY ARPT -PVT
UUDD	DOMODEDOVE INTL ARPT
UUEE	SHEREMETYEVO INTL
VABB	BOMBAY/MUMBAI
VHHH	HONG KONG INTL
VI22	CHARLOTTE AMALIE HARBOR SEAPLANE BASE
VIDP	INDIRA GANDHI INTL
VOBG	BANGALORE INTL ARPT
VTBD	DON MUEANG INTL ARPT
VTBS	SUVARNABHUMI INTL ARPT
VVNB	NOI BAI INTL ARPT
VVTS	TANSONNHAT
W13	EAGLES NEST ARPT
W22	UPSHUR COUNTY REGIONAL ARPT
W28	SEQUIM VALLEY ARPT
W29	BAY BRIDGE
W32	WASHINGTON EXECUTIVE ARPT HYDE FIELD
W39	ROCHE HARBOR -SPB
W40	MOUNT OLIVE MUNICIPAL ARPT
W48	ESSEX SKYPARK
W50	DAVIS AIRPORT
W78	WILLIAM M TUCK ARPT
W91	SMITH MOUNTAIN LAKE
W96	NEW KENT COUNTY
WIII	SOEKARNO-HATTA
WMKK	KUALA LUMPUR INTL
WMKP	PENANG INTL
WSSL	SELETAR ARPT
WSSS	CHANGI INTL -SINGAPORE
WV27	CABELL HUNTINGTON HOSPITAL HELIPORT
WV42	WEIRTON-STEUBENVILLE
X06	ARCADIA MUNICIPAL ARPT
X13	CARRABELLE-THOMPSON
X21	ARTHUR DUNN AIR PARK
X26	SEBASTIAN MUNICIPAL
X35	MARION COUNTY ARPT
X46	OPA LOCKA WEST
X50	MASSEY RANCH AIRPARK
X51	HOMESTEAD GENERAL AVIATION ARPT
X58	INDIANTOWN
X59	VALKARIA
X60	WILLISTON MUNICIPAL ARPT
XS40	JAY KAY RANCH ARPT
XS90	FENTRESS AIRPARK
Y19	MANDAN MUNICIPAL
Y31	WEST BRANCH COMMUNITY ARPT
Y50	WAUTOMA MUNICIPAL
Y55	CRANDON/STEVE CONWAY MUNI ARPT
Y65	CALVIN CAMPBELL MUNICIPAL
Y70	IONIA COUNTY
YBHM	HAMILTON ISLAND
YMML	MELBOURNE AUSTRALIA
YSSY	SYDNEY INTL ARPT
Z41	LAKE HOOD STRIP ARPT
ZBAA	CAPITAL -BEIJING
ZBTJ	TIANJIN -CHINA
ZGGG	BAIYUN AIRPORT
ZGSZ	SHENZHEN BAOAN INTL ARPT
ZSPD	PU DONG INTL ARPT
ZSQD	QINGDAO LIUTING INTL ARPT
ZUUU	SHUANGLIU ARPT
ZZZZ	UNKNOWN
